[Assembly-CSharp].NetObf.StrEncrypt::譟赛	哞
[Assembly-CSharp].NetObf.StrEncrypt::菝帩	呆
[Assembly-CSharp-firstpass].NetObf.StrEncrypt::驒뿯턳	厪
[Assembly-CSharp].NetObf.StrEncrypt::鱾疐	唚
[Assembly-CSharp].NetObf.StrEncrypt::繮墩	哉
[Assembly-CSharp-firstpass].NetObf.StringLocalization::SelectLocalizationName System.Boolean([mscorlib].System.String)	匏
[Assembly-CSharp].NetObf.StrEncrypt::囒蒑턳	唅
[Assembly-CSharp-firstpass].NetObf.StrEncrypt::褜浜턴	占
[Assembly-CSharp-firstpass].UnityStandardAssets.Utility.ParticleSystemDestroyer/<Start>c__Iterator0::$this	咎
[Assembly-CSharp].NetObf.DemoMode::st_group	匯
[Assembly-CSharp-firstpass].NetObf.StrEncrypt::澥渖儶	呡
[Assembly-CSharp].NetObf.StrEncrypt::濐ꀍ턳	唖
[Assembly-CSharp-firstpass].NetObf.StrEncrypt::鹰媥턴	叱
[Assembly-CSharp-firstpass].NetObf.StrEncrypt::礌뷻턴	呉
[Assembly-CSharp].NetObf.StrEncrypt::螧埥	叏
[Assembly-CSharp].NetObf.BaseMeshSerializer::def_headerSize	呺
[Assembly-CSharp-firstpass].NetObf.StrEncrypt::_STRING_ENCRYPT_KEY	卋
[Assembly-CSharp-firstpass].NetObf.StrEncrypt::GetDefaultEncryptPassword System.UInt32()	呴
[Assembly-CSharp-firstpass].NetObf.StrEncrypt::덤灗	叴
[Assembly-CSharp].NetObf.StrEncrypt::褟浘턴	卵
[Assembly-CSharp-firstpass].NetObf.StrEncrypt::岹겺턴	卸
[Assembly-CSharp].NetObf.StrEncrypt::鴉뵏턳	哮
[Assembly-CSharp-firstpass].NetObf.StrEncrypt::褓浸턴	卓
[Assembly-CSharp-firstpass].NetObf.StrEncrypt::褢浞턴	危
[Assembly-CSharp].NetObf.StrEncrypt::솫鵛턴	吗
[Assembly-CSharp].NetObf.StrEncrypt::뿎朒儶	啦
[Assembly-CSharp-firstpass].NetObf.StrEncrypt::褗浌턴	卩
[Assembly-CSharp-firstpass].NetObf.StrEncrypt::艟빣턴	呅
[Assembly-CSharp].NetObf.StringLocalization::GetStringHash System.UInt32([mscorlib].System.String)	匝
[Assembly-CSharp-firstpass].NetObf.ResourcesEncryption::LoadEncryptedResourceAssetBundle UnityEngine.AssetBundle([mscorlib].System.String,[mscorlib].System.String)	卉
[Assembly-CSharp].NetObf.PlayerPrefsProtected::HasKey System.Boolean([mscorlib].System.String)	匣
[Assembly-CSharp-firstpass].NetObf.StrEncrypt::褙浞턴	卧
[Assembly-CSharp].NetObf.StrEncrypt::褏浘턴	卜
[Assembly-CSharp-firstpass].NetObf.ResourcesTools::resources	匹
[Assembly-CSharp-firstpass].NetObf.StrEncrypt::뱩쌺	叹
[Assembly-CSharp-firstpass].NetObf.BaseMeshSerializer::WriteTriangleIndicies System.Void([mscorlib].System.IO.BinaryWriter,[mscorlib].System.Int32[])	咄
[Assembly-CSharp].NetObf.StrEncrypt::缓替턳	咼
[Assembly-CSharp].NetObf.StrEncrypt::좙皭턴	哬
[Assembly-CSharp].NetObf.StringLocalization::LocalizedResourcesLoad_Template T([mscorlib].System.String)	北`1
[Assembly-CSharp].NetObf.StrEncrypt::絙姢儶	喀
[Assembly-CSharp].NetObf.StrEncrypt::葟芑儶	啮
[Assembly-CSharp-firstpass].NetObf.StrEncrypt::褒浈턴	单
[Assembly-CSharp].NetObf.StrEncrypt::賿礜턴	啒
[Assembly-CSharp].NetObf.StringLocalization::SelectLocalizationName System.Boolean([mscorlib].System.String)	匏
[Assembly-CSharp-firstpass].NetObf.Crypto::DecryptBytes System.Byte[]([mscorlib].System.String,[mscorlib].System.String)	咋
[Assembly-CSharp].NetObf.StrEncrypt::岹겺턴	卸
[Assembly-CSharp-firstpass].NetObf.StrEncrypt::劸巆턴	厥
[Assembly-CSharp].NetObf.PlayerPrefsProtected::SetInt System.Void([mscorlib].System.String,[mscorlib].System.Int32)	匩
[Assembly-CSharp-firstpass].NetObf.StrEncrypt::맞긁턴	呀
[Assembly-CSharp-firstpass].NetObf.StrEncrypt::ꖧ칻턳	呫
[Assembly-CSharp-firstpass].NetObf.StrEncrypt::좒쳗턳	可
[Assembly-CSharp].NetObf.StrEncrypt::櫔欣儶	厏
[Assembly-CSharp].NetObf.StrEncrypt::ꡕ嬿턳	压
[Assembly-CSharp-firstpass].NetObf.StrEncrypt::褩洦턴	卼
[Assembly-CSharp].NetObf.StrEncrypt::萋嚟	啋
[Assembly-CSharp-firstpass].NetObf.StrEncrypt::褑浀턴	卞
[Assembly-CSharp].NetObf.DM::expirationTime3	匷
[Assembly-CSharp].NetObf.ResourcesEncryption::LoadEncryptedResourceAssetBundle UnityEngine.AssetBundle([mscorlib].System.String,[mscorlib].System.String)	卉
[Assembly-CSharp].NetObf.BaseMeshSerializer::WriteTriangleIndicies System.Void([mscorlib].System.IO.BinaryWriter,[mscorlib].System.Int32[])	咄
[Assembly-CSharp].NetObf.StringLocalization::GetSelectedLocalizationName System.String()	匐
[Assembly-CSharp-firstpass].NetObf.StrEncrypt::鮭ꐜ턴	叵
[Assembly-CSharp].NetObf.StrEncrypt::褣浌턴	卬
[Assembly-CSharp-firstpass].NetObf.ResourcesEncryption::LoadEncryptedResourceText System.String([mscorlib].System.String,[mscorlib].System.String)	卄
[Assembly-CSharp-firstpass].UnityStandardAssets.Utility.TimedObjectActivator/<Deactivate>c__Iterator1::$PC	咑
[Assembly-CSharp-firstpass].NetObf.StrEncrypt::좿좤턴	厣
[Assembly-CSharp-firstpass].NetObf.StrEncrypt::獣禬턳	厨
[Assembly-CSharp-firstpass].NetObf.StringLocalization::_LoadDefaultResorceFile System.Boolean([mscorlib].System.String)	匙
[Assembly-CSharp-firstpass].UnityStandardAssets.Utility.ObjectResetter/<ResetCoroutine>c__Iterator0::$PC	咑
[Assembly-CSharp].NetObf.StrEncrypt::ꔈ疐	唘
[Assembly-CSharp-firstpass].NetObf.StrEncrypt::퀋썷턴	听
[Assembly-CSharp].NetObf.StrEncrypt::褠浔턴	却
[Assembly-CSharp-firstpass].NetObf.StrEncrypt::蚮璻	吼
[Assembly-CSharp].NetObf.ResourcesEncryption::LoadEncryptedResourceTextureEx UnityEngine.Texture2D([mscorlib].System.String,[mscorlib].System.String,[mscorlib].System.Int32,[mscorlib].System.Int32,[UnityEngine.CoreModule].UnityEngine.TextureFormat,[mscorlib].System.Boolean,[mscorlib].System.Boolean)	升
[Assembly-CSharp-firstpass].NetObf.DemoMode	.咛
[Assembly-CSharp-firstpass].NetObf.StrEncrypt::襾醇	呪
[Assembly-CSharp].NetObf.StrEncrypt::됂睋턴	咯
[Assembly-CSharp-firstpass].NetObf.ImageConversionCustom::LoadImage_bytes	匽
[Assembly-CSharp].Assets.Scripts.AudioControl.CalibrationTypes.CalibrationStyleLowFirst/<Calibrate>c__Iterator0::$current	咏
[Assembly-CSharp-firstpass].NetObf.Test	.咙
[Assembly-CSharp-firstpass].UnityStandardAssets.Utility.ParticleSystemDestroyer/<Start>c__Iterator0::$current	咏
[Assembly-CSharp-firstpass].NetObf.StrEncrypt::褐浠턴	卒
[Assembly-CSharp].NetObf.StrEncrypt::絙姤儶	啿
[Assembly-CSharp-firstpass].NetObf.StrEncrypt::뾫쟈턳	古
[Assembly-CSharp-firstpass].NetObf.Test::TestStr System.Boolean()	匠
[Assembly-CSharp].NetObf.BaseMeshSerializer::Save System.Byte[]([mscorlib].System.Collections.Generic.IEnumerable`1)	匤
[Assembly-CSharp].NetObf.StrEncrypt::課猽턴	咿
[Assembly-CSharp-firstpass].NetObf.StrEncrypt::祯漣턳	呇
[Assembly-CSharp].NetObf.StrEncrypt::褒浤턴	南
[Assembly-CSharp-firstpass].NetObf.StrEncrypt::輐郐턳	厊
[Assembly-CSharp].NetObf.ImageConversionCustom::LoadImage_bytes	匽
[Assembly-CSharp-firstpass].NetObf.StrEncrypt::嚧앣턳	叨
[Assembly-CSharp].NetObf.StrEncrypt::ꍠ灮턳	咶
[Assembly-CSharp].NetObf.StrEncrypt::褑浀턴	卞
[Assembly-CSharp].NetObf.StrEncrypt::鯨鱇	哔
[Assembly-CSharp].NetObf.ResourcesEncryption::LoadEncryptedResourceDisbaleLocalization System.Void([mscorlib].System.Boolean)	千
[Assembly-CSharp-firstpass].NetObf.DM::expirationTime3	匷
[Assembly-CSharp-firstpass].NetObf.DM::expirationTime4	匸
[Assembly-CSharp].NetObf.StrEncrypt::ꁗ릮儶	哝
[Assembly-CSharp].NetObf.StringLocalization::LoadLocalizationFileFromText System.Boolean([mscorlib].System.String)	匔
[Assembly-CSharp].NetObf.Crypto::prefix2	咈
[Assembly-CSharp].NetObf.DemoMode::expirationTime2	匮
[Assembly-CSharp].NetObf.ImageConversionCustom::LoadImage_2017 System.Boolean([UnityEngine.CoreModule].UnityEngine.Texture2D,[mscorlib].System.Byte[])	匿
[Assembly-CSharp-firstpass].NetObf.BaseMeshSerializer::Load System.Collections.Generic.IList`1<UnityEngine.Mesh>([mscorlib].System.Byte[])	呻
[Assembly-CSharp-firstpass].NetObf.StrEncrypt::褏浘턴	卜
[Assembly-CSharp].NetObf.StrEncrypt::컅婦턴	唲
[Assembly-CSharp].NetObf.StrEncrypt::뵯腩儶	哒
[Assembly-CSharp].NetObf.StrEncrypt::뿌신儶	唄
[Assembly-CSharp-firstpass].NetObf.StrEncrypt::禾ꍏ턴	卺
[Assembly-CSharp-firstpass].NetObf.StrEncrypt::극욷儶	叻
[Assembly-CSharp-firstpass].NetObf.StrEncrypt::ꙇꊥ턳	厅
[Assembly-CSharp-firstpass].NetObf.StrEncrypt::EncryptStringUTF8 System.String([mscorlib].System.String)	呸
[Assembly-CSharp-firstpass].NetObf.StrEncrypt::湳꫚儶	吒
[Assembly-CSharp-firstpass].NetObf.StrEncrypt::鞥冿턴	受
[Assembly-CSharp].NetObf.StrEncrypt::Ꙑ嵗턴	唢
[Assembly-CSharp-firstpass].NetObf.BaseMeshSerializer::ReadTriangleIndicies System.Int32[]([mscorlib].System.IO.BinaryReader,[mscorlib].System.Int32)	咅
[Assembly-CSharp].NetObf.StrEncrypt::驧尠	唨
[Assembly-CSharp].NetObf.DM	.喊
[Assembly-CSharp-firstpass].NetObf.StrEncrypt::褙浢턴	卨
[Assembly-CSharp].NetObf.StrEncrypt::꿃跿儶	啵
[Assembly-CSharp].NetObf.StrEncrypt::袵沀턴	哅
[Assembly-CSharp].NetObf.StrEncrypt::list	卌
[Assembly-CSharp-firstpass].NetObf.DemoMode::st_group	匯
[Assembly-CSharp].NetObf.StrEncrypt::닧狪턴	唈
[Assembly-CSharp-firstpass].NetObf.StrEncrypt::櫋徬턳	厷
[Assembly-CSharp-firstpass].NetObf.StrEncrypt::饳ꀲ턳	呚
[Assembly-CSharp].NetObf.StringLocalization::_Localization System.String([mscorlib].System.Int32)	匎
[Assembly-CSharp-firstpass].NetObf.StrEncrypt::褐浢턴	博
[Assembly-CSharp].NetObf.StrEncrypt::鳏泿턳	哦
[Assembly-CSharp-firstpass].NetObf.PlayerPrefsProtected::GetString System.String([mscorlib].System.String)	匧
[Assembly-CSharp-firstpass].NetObf.Crypto::prefix	咇
[Assembly-CSharp].NetObf.ResourcesTools::resources	匹
[Assembly-CSharp-firstpass].NetObf.StrEncrypt::褡浚턴	卲
[Assembly-CSharp-firstpass].NetObf.StrEncrypt::鮿ꒃ儶	双
[Assembly-CSharp-firstpass].NetObf.StringLocalization::PlayerPrefsSetString System.Void([mscorlib].System.String,[mscorlib].System.String)	匈
[Assembly-CSharp].NetObf.StrEncrypt::痣塴	咰
[Assembly-CSharp-firstpass].NetObf.StrEncrypt::퀋ꅿ턴	吭
[Assembly-CSharp].NetObf.PlayerPrefsProtected::GetFloat System.Single([mscorlib].System.String,[mscorlib].System.Single)	匥
[Assembly-CSharp].NetObf.StrEncrypt::焈廤턳	哳
[Assembly-CSharp-firstpass].NetObf.StrEncrypt::裛泊턴	卿
[Assembly-CSharp-firstpass].NetObf.StrEncrypt::脖縷	厈
[Assembly-CSharp-firstpass].NetObf.StrEncrypt::嵠諬턳	吙
[Assembly-CSharp].NetObf.StrEncrypt::褚浌턴	卦
[Assembly-CSharp].NetObf.StrEncrypt::饾渮턳	哛
[Assembly-CSharp-firstpass].NetObf.StringLocalization::ReadFromUnityResorceAsset System.String([mscorlib].System.String)	匜
[Assembly-CSharp-firstpass].NetObf.BaseMeshSerializer::DeserializeMeshes System.Collections.Generic.IEnumerable`1<UnityEngine.Mesh>([mscorlib].System.Byte[])	命
[Assembly-CSharp].NetObf.StrEncrypt::쮳婩턳	哼
[Assembly-CSharp-firstpass].NetObf.StrEncrypt::炅ꏢ儶	友
[Assembly-CSharp-firstpass].NetObf.StrEncrypt::梣웪儶	吃
[Assembly-CSharp].NetObf.StrEncrypt::褏浌턴	卛
[Assembly-CSharp-firstpass].NetObf.StrEncrypt::徂ꢰ턴	吠
[Assembly-CSharp].NetObf.ResourcesEncryption::LoadEncryptedResourceTexture UnityEngine.Texture2D([mscorlib].System.String,[mscorlib].System.String)	卆
[Assembly-CSharp].NetObf.StrEncrypt::嚖롃	唂
[Assembly-CSharp-firstpass].NetObf.StrEncrypt::겪蟣儶	吮
[Assembly-CSharp-firstpass].NetObf.ResourcesEncryption::LoadEncryptedResourceTextureEx UnityEngine.Texture2D([mscorlib].System.String,[mscorlib].System.String,[mscorlib].System.Int32,[mscorlib].System.Int32,[UnityEngine.CoreModule].UnityEngine.TextureFormat,[mscorlib].System.Boolean,[mscorlib].System.Boolean)	升
[Assembly-CSharp-firstpass].NetObf.BaseMeshSerializer::SerializeMeshes System.Byte[]([mscorlib].System.Collections.Generic.IEnumerable`1)	呼
[Assembly-CSharp].NetObf.StrEncrypt::뼙꣔	哺
[Assembly-CSharp].NetObf.BaseMeshSerializer::WriteVertices System.Void([mscorlib].System.IO.BinaryWriter,[UnityEngine.CoreModule].UnityEngine.Vector3[],[UnityEngine.CoreModule].UnityEngine.Transform)	咂
[Assembly-CSharp-firstpass].NetObf.StrEncrypt::硱坚턴	厯
[Assembly-CSharp-firstpass].UnityStandardAssets.Utility.TimedObjectActivator/<Deactivate>c__Iterator1::$disposing	咐
[Assembly-CSharp-firstpass].NetObf.StrEncrypt::褗浒턴	卙
[Assembly-CSharp-firstpass].NetObf.StrEncrypt::璾잹	吅
[Assembly-CSharp].NetObf.StrEncrypt::裘泊턴	卽
[Assembly-CSharp].NetObf.StrEncrypt::敽囖턴	唤
[Assembly-CSharp-firstpass].NetObf.StrEncrypt::墌鼪儶	厴
[Assembly-CSharp].NetObf.StrEncrypt::褑浈턴	単
[Assembly-CSharp-firstpass].NetObf.ImageConversionCustom::EncodeToPNG_2017 System.Byte[]([UnityEngine.CoreModule].UnityEngine.Texture2D)	區
[Assembly-CSharp].NetObf.ResourcesEncryption::disableLocalization	卂
[Assembly-CSharp].NetObf.ImageConversionCustom::EncodeToPNG_2017 System.Byte[]([UnityEngine.CoreModule].UnityEngine.Texture2D)	區
[Assembly-CSharp-firstpass].NetObf.StrEncrypt::쎚Ꙏ	厾
[Assembly-CSharp].NetObf.StrEncrypt::簍饂턳	啇
[Assembly-CSharp-firstpass].NetObf.StrEncrypt::袷泊턴	厍
[Assembly-CSharp-firstpass].NetObf.StrEncrypt::褝浠턴	卡
[Assembly-CSharp-firstpass].NetObf.StrEncrypt::褐浤턴	印
[Assembly-CSharp].NetObf.StrEncrypt::脡糦턳	啉
[Assembly-CSharp-firstpass].NetObf.StrEncrypt::枕딉턳	厜
[Assembly-CSharp].NetObf.StrEncrypt::蟥簁턳	啣
[Assembly-CSharp-firstpass].NetObf.StrEncrypt::殛幃儶	呭
[Assembly-CSharp-firstpass].NetObf.StrEncrypt::櫔欣儶	厏
[Assembly-CSharp].NetObf.StrEncrypt::딶碴	唹
[Assembly-CSharp-firstpass].NetObf.StrEncrypt::嚯食儶	叡
[Assembly-CSharp-firstpass].NetObf.BaseMeshSerializer::ReadVertices UnityEngine.Vector3[]([mscorlib].System.IO.BinaryReader,[mscorlib].System.Int32)	咃
[Assembly-CSharp].NetObf.PlayerPrefsProtected::GetInt System.Int32([mscorlib].System.String)	匦
[Assembly-CSharp].NetObf.StrEncrypt::ꮎ벬	啥
[Assembly-CSharp].NetObf.StrEncrypt::结矄턴	啕
[Assembly-CSharp-firstpass].NetObf.PlayerPrefsProtected::DeleteKey System.Void([mscorlib].System.String)	匢
[Assembly-CSharp].NetObf.StrEncrypt::褣浠턴	协
[Assembly-CSharp-firstpass].UnityStandardAssets.Utility.TimedObjectActivator/<ReloadLevel>c__Iterator2::$disposing	咐
[Assembly-CSharp-firstpass].NetObf.StrEncrypt::禒뜣턴	厙
[Assembly-CSharp].NetObf.StrEncrypt::褩洲턴	厂
[Assembly-CSharp-firstpass].NetObf.StrEncrypt::覫璻儶	吏
[Assembly-CSharp].NetObf.StrEncrypt::褐浠턴	卒
[Assembly-CSharp-firstpass].NetObf.StrEncrypt::챑뤔턴	厔
[Assembly-CSharp].NetObf.StrEncrypt::翳隣儶	啻
[Assembly-CSharp].NetObf.StrEncrypt::袶沌턴	卻
[Assembly-CSharp].NetObf.StringLocalization::LoadDefaults System.Void()	匘
[Assembly-CSharp-firstpass].NetObf.PlayerPrefsProtected::DeleteAll System.Void()	匡
[Assembly-CSharp-firstpass].NetObf.StringLocalization::AddToDefault System.Void([mscorlib].System.String)	匋
[Assembly-CSharp-firstpass].NetObf.StrEncrypt::鴚拉	叝
[Assembly-CSharp-firstpass].NetObf.StrEncrypt::蛓寶턳	吊
[Assembly-CSharp].NetObf.StrEncrypt::觖鞫	哤
[Assembly-CSharp-firstpass].NetObf.BaseMeshSerializer	.咡
[Assembly-CSharp-firstpass].NetObf.StrEncrypt::褠浔턴	却
[Assembly-CSharp-firstpass].NetObf.ResourcesEncryption::disableLocalization	卂
[Assembly-CSharp].NetObf.StrEncrypt::絙姆儶	喁
[Assembly-CSharp-firstpass].NetObf.StrEncrypt::吝昂턴	叺
[Assembly-CSharp-firstpass].NetObf.StrEncrypt::驭晄턳	吆
[Assembly-CSharp].NetObf.StrEncrypt::ꅎ怋턳	哨
[Assembly-CSharp-firstpass].NetObf.StrEncrypt::즾깁	呦
[Assembly-CSharp].NetObf.StrEncrypt::厕养턴	唰
[Assembly-CSharp].NetObf.StrEncrypt::溯噓	啬
[Assembly-CSharp-firstpass].NetObf.StrEncrypt::珡瑪턳	吐
[Assembly-CSharp].NetObf.StrEncrypt::騈骀턴	唽
[Assembly-CSharp].NetObf.StrEncrypt::霮鸬턳	唊
[Assembly-CSharp-firstpass].NetObf.StringLocalization/lang	匁
[Assembly-CSharp]..<PrivateImplementationDetails>/.$ArrayType=12	喒
[Assembly-CSharp].NetObf.StrEncrypt::ꁒ翓儶	哭
[Assembly-CSharp].NetObf.StrEncrypt::褥浢턴	卫
[Assembly-CSharp].NetObf.StrEncrypt::浠궥턴	唀
[Assembly-CSharp-firstpass].NetObf.StrEncrypt::扶륑턳	呞
[Assembly-CSharp].NetObf.StrEncrypt::娕꟡턳	啓
[Assembly-CSharp-firstpass].NetObf.StrEncrypt::嵸钅턳	厳
[Assembly-CSharp-firstpass].NetObf.StrEncrypt::捝꧎	叾
[Assembly-CSharp].NetObf.StrEncrypt::庙洷턳	啐
[Assembly-CSharp-firstpass].NetObf.StrEncrypt::쾅圓	厵
[Assembly-CSharp].Assets.Scripts.GameScripts.UI.Calibrate/<HandleCalibration>c__Iterator0::$PC	咑
[Assembly-CSharp-firstpass].NetObf.StrEncrypt::뮊凾턳	呲
[Assembly-CSharp].NetObf.BaseMeshSerializer::Load System.Collections.Generic.IList`1<UnityEngine.Mesh>([mscorlib].System.Byte[])	呻
[Assembly-CSharp-firstpass].NetObf.StrEncrypt::默鐿儶	厗
[Assembly-CSharp-firstpass].NetObf.StrEncrypt::ꔆ攻儶	君
[Assembly-CSharp].NetObf.StrEncrypt::蕵熤	咪
[Assembly-CSharp-firstpass].NetObf.StrEncrypt::贕ꖌ	吴
[Assembly-CSharp-firstpass].NetObf.StrEncrypt::뿛芚儶	厒
[Assembly-CSharp].NetObf.StrEncrypt::줞箥턳	厓
[Assembly-CSharp-firstpass].NetObf.StrEncrypt::故擪턳	含
[Assembly-CSharp-firstpass].NetObf.StrEncrypt::欸躩턴	吡
[Assembly-CSharp].NetObf.StrEncrypt::磅桖儶	唁
[Assembly-CSharp-firstpass].NetObf.StrEncrypt::舫누턴	厤
[Assembly-CSharp-firstpass].NetObf.PlayerPrefsProtected::GetFloat System.Single([mscorlib].System.String,[mscorlib].System.Single)	匥
[Assembly-CSharp].NetObf.StrEncrypt::篖ꙺ턳	售
[Assembly-CSharp-firstpass].NetObf.StrEncrypt::褑浈턴	単
[Assembly-CSharp-firstpass].NetObf.StrEncrypt::疿뉧턳	叼
[Assembly-CSharp].NetObf.StrEncrypt::쭱首턳	唩
[Assembly-CSharp-firstpass].NetObf.StrEncrypt::钣夀턴	吂
[Assembly-CSharp].NetObf.StrEncrypt::褫浚턴	卖
[Assembly-CSharp].NetObf.StrEncrypt::谢趄턴	哕
[Assembly-CSharp].NetObf.StrEncrypt::栋刀턴	吶
[Assembly-CSharp-firstpass].NetObf.StrEncrypt::늸꘡턳	反
[Assembly-CSharp-firstpass].NetObf.StrEncrypt::놔跇儶	呖
[Assembly-CSharp].Assets.Scripts.AudioControl.CalibrationTypes.CalibrationStyleMiddleFirst/<Calibrate>c__Iterator0::$PC	咑
[Assembly-CSharp].NetObf.StrEncrypt::褢浚턴	卭
[Assembly-CSharp].NetObf.StrEncrypt::蜩ꊎ턳	历
[Assembly-CSharp-firstpass].NetObf.StrEncrypt::棤歰턳	吪
[Assembly-CSharp].NetObf.Crypto::Decrypt_GetMeta System.String([mscorlib].System.String)	和
[Assembly-CSharp].NetObf.StrEncrypt::跠ꦋ儶	啽
[Assembly-CSharp].NetObf.StrEncrypt::囱꼒儶	咷
[Assembly-CSharp].NetObf.StrEncrypt::ꅫ椵턴	响
[Assembly-CSharp-firstpass].NetObf.StrEncrypt::媄鸁儶	员
[Assembly-CSharp].NetObf.Crypto::Decrypt System.Byte[]([mscorlib].System.Byte[],[mscorlib].System.String)	咉
[Assembly-CSharp].NetObf.StrEncrypt::補泊턴	厁
[Assembly-CSharp].NetObf.StrEncrypt::셧閃턳	咬
[Assembly-CSharp].NetObf.StrEncrypt::寊쥺턳	啧
[Assembly-CSharp].NetObf.PlayerPrefsProtected::SetFloat System.Void([mscorlib].System.String,[mscorlib].System.Single)	匨
[Assembly-CSharp].NetObf.StrEncrypt::_STRING_ENCRYPT_KEY	卋
[Assembly-CSharp-firstpass].NetObf.StrEncrypt::睔蟁턳	呈
[Assembly-CSharp].NetObf.StrEncrypt::蒲趐儶	哌
[Assembly-CSharp].NetObf.StringLocalization::table_base	匄
[Assembly-CSharp-firstpass].NetObf.StrEncrypt::肹惘儶	呛
[Assembly-CSharp-firstpass].NetObf.StrEncrypt::撞ꡟ턴	叇
[Assembly-CSharp-firstpass].NetObf.StrEncrypt::럨禫턴	又
[Assembly-CSharp].NetObf.StrEncrypt::秦띢턴	唡
[Assembly-CSharp].NetObf.StrEncrypt::讔쌒턳	啢
[Assembly-CSharp-firstpass].UnityStandardAssets.Utility.TimedObjectActivator/<Activate>c__Iterator0::$PC	咑
[Assembly-CSharp-firstpass].NetObf.StringLocalization::LoadDefaults System.Void()	匘
[Assembly-CSharp-firstpass].NetObf.StringLocalization::FindInChangeLang System.Action([System.Core].System.Action)	匞
[Assembly-CSharp-firstpass].UnityStandardAssets.Utility.ParticleSystemDestroyer/<Start>c__Iterator0::$locvar3	咖
[Assembly-CSharp].NetObf.PlayerPrefsProtected::DeleteAll System.Void()	匡
[Assembly-CSharp].Assets.Scripts.AudioControl.CalibrationTypes.CalibrationStyleLowFirst/<Calibrate>c__Iterator0::$this	咎
[Assembly-CSharp].NetObf.StrEncrypt::鑽繱턳	啺
[Assembly-CSharp].NetObf.StrEncrypt::藖뵅턴	啊
[Assembly-CSharp].NetObf.BaseMeshSerializer::WriteMesh System.Void([mscorlib].System.IO.BinaryWriter,[UnityEngine.CoreModule].UnityEngine.Mesh,[UnityEngine.CoreModule].UnityEngine.Transform)	呾
[Assembly-CSharp].NetObf.PlayerPrefsProtected::GetString System.String([mscorlib].System.String)	匧
[Assembly-CSharp-firstpass].NetObf.StrEncrypt::ꄄ檍儶	合
[Assembly-CSharp].NetObf.DemoMode::IsExpiredLevel System.Int32()	匲
[Assembly-CSharp].NetObf.StrEncrypt::褩洢턴	厀
[Assembly-CSharp-firstpass].NetObf.StringLocalization::RemoveFromChangeLang System.Void([System.Core].System.Action)	匓
[Assembly-CSharp].NetObf.StrEncrypt::웷炁턳	啞
[Assembly-CSharp].NetObf.StrEncrypt::ꢒꦧ儶	哚
[Assembly-CSharp].NetObf.StrEncrypt::褜济턴	卣
[Assembly-CSharp-firstpass].UnityStandardAssets.Vehicles.Car.SkidTrail/<Start>c__Iterator0::$PC	咑
[Assembly-CSharp].NetObf.StringLocalization::PlayerPrefsSetString System.Void([mscorlib].System.String,[mscorlib].System.String)	匈
[Assembly-CSharp].NetObf.StrEncrypt::긩듵	咮
[Assembly-CSharp].NetObf.StrEncrypt::袸泊턴	厄
[Assembly-CSharp-firstpass].NetObf.Crypto::_DefaultEncryptPassword	咆
[Assembly-CSharp].NetObf.StrEncrypt::逺聓儶	哲
[Assembly-CSharp-firstpass].NetObf.StrEncrypt::캟눘	吵
[Assembly-CSharp].NetObf.StrEncrypt::鴝첆턳	哜
[Assembly-CSharp].NetObf.StrEncrypt::ꯌ쉰儶	啑
[Assembly-CSharp-firstpass].NetObf.StrEncrypt::놔跉儶	呕
[Assembly-CSharp].NetObf.StrEncrypt::欸躩턴	吡
[Assembly-CSharp].NetObf.StrEncrypt::梋겑턴	唥
[Assembly-CSharp-firstpass].NetObf.StringLocalization	.咘
[Assembly-CSharp].NetObf.StrEncrypt::턋랟턳	厉
[Assembly-CSharp].NetObf.StrEncrypt::Ꙑ嵑턴	唣
[Assembly-CSharp].NetObf.StrEncrypt::禨꼘턴	唾
[Assembly-CSharp].NetObf.StrEncrypt::囼怕턴	哸
[Assembly-CSharp-firstpass].NetObf.StrEncrypt::ꑮ纥턳	名
[Assembly-CSharp].NetObf.Crypto::DecryptString System.String([mscorlib].System.String,[mscorlib].System.String)	咍
[Assembly-CSharp-firstpass].NetObf.ResourcesTools::GetResourceStream System.IO.Stream([mscorlib].System.Reflection.Assembly,[mscorlib].System.String)	医
[Assembly-CSharp].NetObf.StrEncrypt::鋵须儶	啃
[Assembly-CSharp-firstpass].NetObf.StrEncrypt::灳Ꝿ儶	原
[Assembly-CSharp-firstpass].NetObf.StrEncrypt::謚ꮮ턳	口
[Assembly-CSharp-firstpass].NetObf.DemoMode::VerifyDemoModeExpirationTime_GUI System.Void()	匶
[Assembly-CSharp].NetObf.StrEncrypt::褐浢턴	博
[Assembly-CSharp].NetObf.StrEncrypt::钍洔턳	哱
[Assembly-CSharp-firstpass].NetObf.StrEncrypt::菝帩	呆
[Assembly-CSharp-firstpass].NetObf.StringLocalization::ReadFromAssemblyDirectory System.String([mscorlib].System.String)	匛
[Assembly-CSharp-firstpass].NetObf.StrEncrypt::褔派턴	卐
[Assembly-CSharp-firstpass].UnityStandardAssets.Utility.TimedObjectActivator/<Activate>c__Iterator0::entry	咒
[Assembly-CSharp-firstpass].NetObf.StringLocalization::table	包
[Assembly-CSharp-firstpass].NetObf.StrEncrypt::褔浦턴	卑
[Assembly-CSharp].NetObf.StrEncrypt::떐ꥪ儶	唠
[Assembly-CSharp-firstpass].NetObf.StrEncrypt::褣浌턴	卬
[Assembly-CSharp].NetObf.ResourcesEncryption::LoadEncryptedResourceBinary System.Byte[]([mscorlib].System.String,[mscorlib].System.String)	卅
[Assembly-CSharp-firstpass].NetObf.StrEncrypt::螧埥	叏
[Assembly-CSharp-firstpass].NetObf.PlayerPrefsProtected::SetString System.Void([mscorlib].System.String,[mscorlib].System.String)	匪
[Assembly-CSharp-firstpass].NetObf.StrEncrypt::首攸	吚
[Assembly-CSharp-firstpass].NetObf.StrEncrypt::褚浌턴	卦
[Assembly-CSharp].NetObf.BaseMeshSerializer::WriteMeshHeader System.Void([mscorlib].System.IO.BinaryWriter,[mscorlib].System.Int32,[mscorlib].System.Int32)	咀
[Assembly-CSharp-firstpass].NetObf.StrEncrypt::褩洲턴	厂
[Assembly-CSharp].NetObf.DemoMode::VerifyDemoModeExpirationTime System.Void()	匳
[Assembly-CSharp-firstpass].NetObf.BaseMeshSerializer::Save System.Byte[]([mscorlib].System.Collections.Generic.IEnumerable`1)	匤
[Assembly-CSharp-firstpass].NetObf.StringLocalization::GetLanguageNames System.String[]()	匑
[Assembly-CSharp-firstpass].NetObf.StrEncrypt::줞箥턳	厓
[Assembly-CSharp].NetObf.StrEncrypt::쐹礔턳	喃
[Assembly-CSharp-firstpass].NetObf.StrEncrypt::遮쳈턴	吿
[Assembly-CSharp-firstpass].NetObf.StrEncrypt::좻謦	叔
[Assembly-CSharp].NetObf.StrEncrypt::溝ꗨ턳	哰
[Assembly-CSharp-firstpass].NetObf.StrEncrypt::筰莔	叙
[Assembly-CSharp].NetObf.StrEncrypt::唅뛘턳	啝
[Assembly-CSharp-firstpass].NetObf.StringLocalization::_Localization System.String([mscorlib].System.Int32)	匎
[Assembly-CSharp-firstpass].NetObf.StrEncrypt::欱緩턴	周
[Assembly-CSharp-firstpass].NetObf.StrEncrypt::놔跋儶	呔
[Assembly-CSharp].NetObf.StrEncrypt::褓浸턴	卓
[Assembly-CSharp-firstpass].NetObf.StrEncrypt::꼜豐턳	吥
[Assembly-CSharp].NetObf.StrEncrypt::褢浞턴	危
[Assembly-CSharp].NetObf.StrEncrypt::賖贿턴	啲
[Assembly-CSharp].NetObf.StrEncrypt::褗浌턴	卩
[Assembly-CSharp-firstpass].NetObf.DemoMode::VerifyDemoModeExpirationTimeOnGUI System.Void()	匴
[Assembly-CSharp-firstpass].NetObf.StrEncrypt::跄鋢儶	叆
[Assembly-CSharp-firstpass].NetObf.StrEncrypt::爵뇔	吹
[Assembly-CSharp-firstpass].NetObf.StrEncrypt::ꪌ뜼턳	吲
[Assembly-CSharp].NetObf.StringLocalization::AddToChangeLang System.Void([System.Core].System.Action)	匒
[Assembly-CSharp-firstpass].NetObf.StrEncrypt::녈롙	厭
[Assembly-CSharp].NetObf.StrEncrypt::褛浈턴	卥
[Assembly-CSharp].NetObf.StrEncrypt::짞싙턴	哓
[Assembly-CSharp].NetObf.StrEncrypt::揌뙸儶	哹
[Assembly-CSharp].NetObf.StrEncrypt::떻橷턳	唎
[Assembly-CSharp].NetObf.ImageConversionCustom	.喌
[Assembly-CSharp-firstpass].NetObf.StrEncrypt::탍礵턴	味
[Assembly-CSharp].NetObf.StrEncrypt::褒浈턴	单
[Assembly-CSharp-firstpass].NetObf.StrEncrypt::꾲皑턴	厩
[Assembly-CSharp-firstpass].NetObf.StrEncrypt::ꏽ競	厞
[Assembly-CSharp].NetObf.PlayerPrefsProtected::Save System.Void()	匤
[Assembly-CSharp-firstpass].NetObf.BaseMeshSerializer::WriteMesh System.Void([mscorlib].System.IO.BinaryWriter,[UnityEngine.CoreModule].UnityEngine.Mesh,[UnityEngine.CoreModule].UnityEngine.Transform)	呾
[Assembly-CSharp].NetObf.StrEncrypt::閨ꀄ턳	啗
[Assembly-CSharp-firstpass].NetObf.StrEncrypt::蠡嶍儶	吤
[Assembly-CSharp].NetObf.StrEncrypt::ꛟ牙	啁
[Assembly-CSharp-firstpass].NetObf.StrEncrypt::겙瀵	呒
[Assembly-CSharp].NetObf.StrEncrypt::褩洦턴	卼
[Assembly-CSharp-firstpass].NetObf.StrEncrypt::褛浈턴	卥
[Assembly-CSharp-firstpass].UnityStandardAssets.Utility.ObjectResetter/<ResetCoroutine>c__Iterator0::$locvar1	咔
[Assembly-CSharp-firstpass].NetObf.StrEncrypt::斎냸儶	吋
[Assembly-CSharp-firstpass].NetObf.DemoMode::expirationTime2	匮
[Assembly-CSharp].NetObf.StrEncrypt::탟뷫儶	啩
[Assembly-CSharp].NetObf.DemoMode::ExpirationAfterMinutes	匬
[Assembly-CSharp].NetObf.StrEncrypt::ꡃ鋛	哣
[Assembly-CSharp].NetObf.StrEncrypt::怪줏턴	哥
[Assembly-CSharp-firstpass].NetObf.StrEncrypt::褦泊턴	呍
[Assembly-CSharp].NetObf.StrEncrypt::컅숚턳	唱
[Assembly-CSharp].NetObf.StrEncrypt::뿛芚儶	厒
[Assembly-CSharp].NetObf.StrEncrypt::褢浒턴	卯
[Assembly-CSharp-firstpass].NetObf.StrEncrypt::졉盪	呟
[Assembly-CSharp-firstpass].NetObf.StrEncrypt::럍陱儶	呐
[Assembly-CSharp-firstpass].NetObf.StringLocalization::Get2LetterISOCodeFromSystemLanguage System.String()	匊
[Assembly-CSharp].NetObf.StrEncrypt::輐郐턳	厊
[Assembly-CSharp].NetObf.Test	.喇
[Assembly-CSharp].NetObf.StrEncrypt::ꌘ軝	厌
[Assembly-CSharp-firstpass].NetObf.StrEncrypt::뿺孳	吰
[Assembly-CSharp-firstpass].NetObf.StringLocalization::GetSelectedLocalizationName System.String()	匐
[Assembly-CSharp].NetObf.StrEncrypt::録蔔턴	咽
[Assembly-CSharp-firstpass].UnityStandardAssets.Utility.TimedObjectActivator/<ReloadLevel>c__Iterator2::entry	咒
[Assembly-CSharp-firstpass].NetObf.StringLocalization::LocalizedResourcesLoad UnityEngine.Object([mscorlib].System.String)	匕
[Assembly-CSharp].NetObf.StrEncrypt::뾫쟈턳	古
[Assembly-CSharp-firstpass].NetObf.StrEncrypt::笏즥儶	号
[Assembly-CSharp].NetObf.StrEncrypt::ꗎ纆턴	唴
[Assembly-CSharp-firstpass].NetObf.StrEncrypt::褡浦턴	即
[Assembly-CSharp].NetObf.StrEncrypt::몓쌷儶	哧
[Assembly-CSharp-firstpass].NetObf.StrEncrypt::_DecryptStringFastInd System.String([mscorlib].System.String,[mscorlib].System.Int32)	呵
[Assembly-CSharp-firstpass].NetObf.StrEncrypt::ꗻꬲ儶	厛
[Assembly-CSharp-firstpass].NetObf.DemoMode::DrawExpirationMessage System.Void()	匵
[Assembly-CSharp-firstpass].NetObf.StrEncrypt::褥浢턴	卫
[Assembly-CSharp].NetObf.StrEncrypt::踎飲	哴
[Assembly-CSharp].NetObf.Crypto::IsEncrypted System.Boolean([mscorlib].System.String)	咊
[Assembly-CSharp-firstpass].NetObf.StrEncrypt::褩洎턴	卾
[Assembly-CSharp].NetObf.StrEncrypt::鄌댐儶	哀
[Assembly-CSharp-firstpass].NetObf.StrEncrypt::鸘塯턳	叐
[Assembly-CSharp-firstpass].NetObf.StrEncrypt::娪ꃻ儶	呏
[Assembly-CSharp-firstpass].NetObf.ImageConversionCustom::is2017	匼
[Assembly-CSharp-firstpass].NetObf.StrEncrypt::褏浦턴	卝
[Assembly-CSharp-firstpass].NetObf.StrEncrypt::滲叻儶	吞
[Assembly-CSharp-firstpass].NetObf.StrEncrypt::놔跅儶	呗
[Assembly-CSharp].NetObf.StrEncrypt::_DecryptStringFast System.String([mscorlib].System.String)	呶
[Assembly-CSharp-firstpass].NetObf.StrEncrypt::螯辯儶	叭
[Assembly-CSharp].NetObf.StrEncrypt::Ꝃ젷턳	啙
[Assembly-CSharp-firstpass].UnityStandardAssets.Utility.ObjectResetter/<ResetCoroutine>c__Iterator0::$disposing	咐
[Assembly-CSharp-firstpass].NetObf.StrEncrypt::꽉龬	呙
[Assembly-CSharp].NetObf.DemoMode::IsExpired System.Boolean()	匱
[Assembly-CSharp].NetObf.StrEncrypt::蟋疐	唗
[Assembly-CSharp].NetObf.StrEncrypt::褢浔턴	卮
[Assembly-CSharp-firstpass].NetObf.StrEncrypt::Ꜯꏠ턴	呓
[Assembly-CSharp-firstpass].NetObf.StrEncrypt::央譤儶	吧
[Assembly-CSharp].NetObf.StringLocalization::ReadFromUnityResorceAsset System.String([mscorlib].System.String)	匜
[Assembly-CSharp].NetObf.StrEncrypt::楾欼儶	哟
[Assembly-CSharp].NetObf.StrEncrypt::褡浚턴	卲
[Assembly-CSharp].NetObf.StrEncrypt::큲娩	唉
[Assembly-CSharp].NetObf.StrEncrypt::褙浢턴	卨
[Assembly-CSharp].NetObf.StringLocalization/lang	匁
[Assembly-CSharp-firstpass].NetObf.ResourcesEncryption::LoadEncryptedResourceDisbaleLocalization System.Void([mscorlib].System.Boolean)	千
[Assembly-CSharp-firstpass].NetObf.StrEncrypt::Rnd	卍
[Assembly-CSharp].NetObf.StrEncrypt::鹟衞턴	啫
[Assembly-CSharp-firstpass].NetObf.StrEncrypt::岻솔턴	厐
[Assembly-CSharp-firstpass].NetObf.StrEncrypt::罸ꡍ	否
[Assembly-CSharp].NetObf.DM::expirationTime4	匸
[Assembly-CSharp].NetObf.StrEncrypt::艟빣턴	呅
[Assembly-CSharp-firstpass].NetObf.StrEncrypt::褥浒턴	卪
[Assembly-CSharp].NetObf.StrEncrypt::谫鑞	厑
[Assembly-CSharp-firstpass].NetObf.StrEncrypt::鈈媖	參
[Assembly-CSharp].NetObf.StrEncrypt::懻狴턳	唃
[Assembly-CSharp-firstpass].NetObf.StrEncrypt::얅莉	吢
[Assembly-CSharp-firstpass].UnityStandardAssets.Utility.TimedObjectActivator/<Deactivate>c__Iterator1::entry	咒
[Assembly-CSharp-firstpass].NetObf.StringLocalization::AddToChangeLang System.Void([System.Core].System.Action)	匒
[Assembly-CSharp].NetObf.ResourcesEncryption::LoadEncryptedResourceText System.String([mscorlib].System.String,[mscorlib].System.String)	卄
[Assembly-CSharp-firstpass].NetObf.StrEncrypt::栋刀턴	吶
[Assembly-CSharp].NetObf.StrEncrypt::廚릭儶	哈
[Assembly-CSharp].NetObf.StrEncrypt::恼쫉	唦
[Assembly-CSharp-firstpass].NetObf.StrEncrypt::ꡕ嬿턳	压
[Assembly-CSharp-firstpass].NetObf.Crypto::prefix2	咈
[Assembly-CSharp-firstpass].NetObf.StringLocalization::Translate System.String([mscorlib].System.String)	匌
[Assembly-CSharp].NetObf.StrEncrypt::괥昹	啔
[Assembly-CSharp].NetObf.StrEncrypt::霮鸸턳	唋
[Assembly-CSharp].NetObf.StrEncrypt::裛泊턴	卿
[Assembly-CSharp-firstpass].NetObf.StrEncrypt::ꮒ喭儶	呤
[Assembly-CSharp-firstpass].UnityStandardAssets.Utility.ParticleSystemDestroyer/<Start>c__Iterator0::$PC	咑
[Assembly-CSharp].NetObf.StrEncrypt::뿒랶턴	哫
[Assembly-CSharp].NetObf.StrEncrypt::褉泊턴	厃
[Assembly-CSharp].NetObf.StrEncrypt::삽贩儶	善
[Assembly-CSharp-firstpass].NetObf.StrEncrypt::DecryptStringUTF8 System.String([mscorlib].System.String)	呷
[Assembly-CSharp-firstpass].NetObf.StrEncrypt::氍暿儶	叿
[Assembly-CSharp-firstpass].NetObf.StrEncrypt::褓洼턴	協
[Assembly-CSharp].NetObf.StrEncrypt::ꁉ疐	唙
[Assembly-CSharp].NetObf.Crypto::GetDefaultEncryptPassword System.String()	呴
[Assembly-CSharp].NetObf.StrEncrypt::鸆嚏턴	咦
[Assembly-CSharp-firstpass].NetObf.PlayerPrefsProtected::GetInt System.Int32([mscorlib].System.String)	匦
[Assembly-CSharp-firstpass].NetObf.StrEncrypt::箽떚턳	吱
[Assembly-CSharp].NetObf.StrEncrypt::褙浞턴	卧
[Assembly-CSharp].NetObf.StringLocalization::get_lang UnityEngine.SystemLanguage()	匇
[Assembly-CSharp-firstpass].NetObf.StringLocalization::LocalizedResourcesLoad_Template T([mscorlib].System.String)	北`1
[Assembly-CSharp].Assets.Scripts.GameScripts.UI.MainMenu/<LoadPlayerNames>c__AnonStorey0::$this	咎
[Assembly-CSharp].NetObf.StrEncrypt::褗浒턴	卙
[Assembly-CSharp].NetObf.StrEncrypt::엖굡턳	哶
[Assembly-CSharp-firstpass].NetObf.StrEncrypt::崩듛턳	台
[Assembly-CSharp].NetObf.StrEncrypt::禾ꍏ턴	卺
[Assembly-CSharp-firstpass].NetObf.StrEncrypt::软ꆢ	厡
[Assembly-CSharp-firstpass].NetObf.StrEncrypt::ꂟ蜇儶	卶
[Assembly-CSharp].NetObf.StrEncrypt::绡ꕕ儶	咲
[Assembly-CSharp-firstpass].UnityStandardAssets.Utility.TimedObjectActivator/<Activate>c__Iterator0::$current	咏
[Assembly-CSharp].NetObf.StrEncrypt::筤둊턳	咻
[Assembly-CSharp].NetObf.PlayerPrefsProtected::GetInt System.Int32([mscorlib].System.String,[mscorlib].System.Int32)	匦
[Assembly-CSharp].NetObf.StrEncrypt::GetDefaultEncryptPassword System.UInt32()	呴
[Assembly-CSharp-firstpass].NetObf.ResourcesEncryption	.咟
[Assembly-CSharp].NetObf.StrEncrypt::袷泊턴	厍
[Assembly-CSharp-firstpass].NetObf.StrEncrypt::褟浘턴	卵
[Assembly-CSharp].NetObf.StrEncrypt::褐浤턴	印
[Assembly-CSharp-firstpass].NetObf.StrEncrypt::褉泊턴	厃
[Assembly-CSharp-firstpass].NetObf.StrEncrypt::쟃댷	向
[Assembly-CSharp-firstpass].UnityStandardAssets.Vehicles.Car.SkidTrail/<Start>c__Iterator0::$this	咎
[Assembly-CSharp].NetObf.StrEncrypt::鍙ꥺ턳	啸
[Assembly-CSharp].NetObf.StrEncrypt::簸鶂턳	啍
[Assembly-CSharp-firstpass].NetObf.StrEncrypt::蠡醏턳	吷
[Assembly-CSharp].NetObf.StrEncrypt::嗅뉍턴	咱
[Assembly-CSharp].NetObf.StringLocalization::LocalizedResourcesLoad UnityEngine.Object([mscorlib].System.String)	匕
[Assembly-CSharp].NetObf.StrEncrypt::쇈뵪턴	啡
[Assembly-CSharp-firstpass].UnityStandardAssets.Utility.TimedObjectActivator/<Deactivate>c__Iterator1::$current	咏
[Assembly-CSharp-firstpass].NetObf.StrEncrypt::跈썕턳	叽
[Assembly-CSharp].NetObf.StrEncrypt::蛯糣턳	咨
[Assembly-CSharp-firstpass].NetObf.StrEncrypt::螚蒮儶	去
[Assembly-CSharp].NetObf.PlayerPrefsProtected::DeleteKey System.Void([mscorlib].System.String)	匢
[Assembly-CSharp-firstpass].NetObf.StrEncrypt::馴嶌儶	发
[Assembly-CSharp-firstpass].NetObf.Crypto::GetDefaultEncryptPassword System.String()	呴
[Assembly-CSharp].NetObf.StrEncrypt::吽懍턳	唵
[Assembly-CSharp-firstpass].NetObf.StrEncrypt::ꙑ篰턳	叀
[Assembly-CSharp].NetObf.StrEncrypt::責濿	唑
[Assembly-CSharp-firstpass].NetObf.Test::VerifyString	匟
[Assembly-CSharp-firstpass].NetObf.ResourcesEncryption::LoadEncryptedResourceAssetObject UnityEngine.Object([mscorlib].System.String,[mscorlib].System.String)	半
[Assembly-CSharp-firstpass].NetObf.PlayerPrefsProtected::GetStringHashAsHex System.String([mscorlib].System.String)	匫
[Assembly-CSharp].NetObf.StrEncrypt::君謉턳	咭
[Assembly-CSharp-firstpass].NetObf.PlayerPrefsProtected::GetString System.String([mscorlib].System.String,[mscorlib].System.String)	匧
[Assembly-CSharp].NetObf.StrEncrypt::垂輤턴	唿
[Assembly-CSharp-firstpass].NetObf.StrEncrypt::蒬ꌮ儶	呂
[Assembly-CSharp].NetObf.ImageConversionCustom::LoadImageCustom System.Boolean([UnityEngine.CoreModule].UnityEngine.Texture2D,[mscorlib].System.Byte[])	十
[Assembly-CSharp].NetObf.StrEncrypt::吝昂턴	叺
[Assembly-CSharp-firstpass].NetObf.StrEncrypt::솫鴛儶	呑
[Assembly-CSharp-firstpass].NetObf.StrEncrypt::壬磟턴	叕
[Assembly-CSharp].NetObf.StrEncrypt::빍袁턴	唺
[Assembly-CSharp].NetObf.StrEncrypt::顩鄉턴	啟
[Assembly-CSharp].NetObf.StrEncrypt::瘀옫	啾
[Assembly-CSharp].NetObf.StrEncrypt::譵녁턳	啠
[Assembly-CSharp].NetObf.BaseMeshSerializer::ReadMesh UnityEngine.Mesh([mscorlib].System.IO.BinaryReader)	呿
[Assembly-CSharp-firstpass].NetObf.ImageConversionCustom	.咞
[Assembly-CSharp].NetObf.StrEncrypt::ꈅ姨	唷
[Assembly-CSharp].NetObf.StrEncrypt::蟖蜖儶	啷
[Assembly-CSharp-firstpass].NetObf.PlayerPrefsProtected::SetInt System.Void([mscorlib].System.String,[mscorlib].System.Int32)	匩
[Assembly-CSharp].NetObf.StrEncrypt::까讆儶	哵
[Assembly-CSharp].NetObf.StrEncrypt::嚯食儶	叡
[Assembly-CSharp].NetObf.StrEncrypt::ꋱ罚턳	哩
[Assembly-CSharp-firstpass].NetObf.StrEncrypt::欜闃儶	呰
[Assembly-CSharp-firstpass].NetObf.StrEncrypt::绝謼	另
[Assembly-CSharp-firstpass].NetObf.Crypto::Decrypt_GetMeta System.String([mscorlib].System.String)	和
[Assembly-CSharp].NetObf.ResourcesEncryption::LoadEncryptedResourceAssetObject UnityEngine.Object([mscorlib].System.String,[mscorlib].System.String)	半
[Assembly-CSharp-firstpass].NetObf.BaseMeshSerializer::ReadMesh UnityEngine.Mesh([mscorlib].System.IO.BinaryReader)	呿
[Assembly-CSharp-firstpass].NetObf.StrEncrypt::嘿抑	取
[Assembly-CSharp].NetObf.StrEncrypt::켯麉턴	唍
[Assembly-CSharp-firstpass].NetObf.StrEncrypt::DecryptStringBig System.String([mscorlib].System.String)	呹
[Assembly-CSharp].NetObf.StrEncrypt::莣谸턴	哃
[Assembly-CSharp-firstpass].NetObf.PlayerPrefsProtected::GetStringHash System.UInt32([mscorlib].System.String)	匝
[Assembly-CSharp].NetObf.BaseMeshSerializer	.喏
[Assembly-CSharp-firstpass].NetObf.ResourcesTools::GetResourcesList System.String[]([mscorlib].System.Reflection.Assembly)	区
[Assembly-CSharp].NetObf.DemoMode::DrawExpirationMessage System.Void()	匵
[Assembly-CSharp].NetObf.PlayerPrefsProtected::GetStringHash System.UInt32([mscorlib].System.String)	匝
[Assembly-CSharp].NetObf.StrEncrypt::騸瑀턳	唪
[Assembly-CSharp-firstpass].NetObf.StrEncrypt::嚧룗턴	叧
[Assembly-CSharp-firstpass].NetObf.StrEncrypt::ꗅ咴儶	县
[Assembly-CSharp-firstpass].NetObf.StrEncrypt::첦沯턴	叶
[Assembly-CSharp-firstpass].NetObf.StrEncrypt::_DecryptStringFast System.String([mscorlib].System.String)	呶
[Assembly-CSharp-firstpass].NetObf.StringLocalization::GetLocalizationKey System.Int32([mscorlib].System.String)	匍
[Assembly-CSharp].NetObf.StrEncrypt::履霦儶	哿
[Assembly-CSharp].NetObf.StrEncrypt::쪭凮턳	啭
[Assembly-CSharp-firstpass].NetObf.StrEncrypt::ꦺ瑆턳	吀
[Assembly-CSharp-firstpass].NetObf.StrEncrypt::빶鈇턳	吔
[Assembly-CSharp-firstpass].NetObf.StrEncrypt::鞣ꭩ턴	吸
[Assembly-CSharp].NetObf.StrEncrypt::蜝感	卹
[Assembly-CSharp].NetObf.DemoMode::expirationTime	匭
[Assembly-CSharp].NetObf.StrEncrypt::劕絉턴	哠
[Assembly-CSharp-firstpass].NetObf.StrEncrypt::趬郎儶	吺
[Assembly-CSharp].NetObf.StrEncrypt::妩꾅	咥
[Assembly-CSharp].NetObf.PlayerPrefsProtected	.喈
[Assembly-CSharp-firstpass].NetObf.StrEncrypt::ꋶ灷턴	厧
[Assembly-CSharp].NetObf.StrEncrypt::좝髙	啳
[Assembly-CSharp].NetObf.StrEncrypt::豵턣턳	哢
[Assembly-CSharp].Assets.Scripts.GameScripts.UI.MainMenu/<LoadPlayerNames>c__AnonStorey0::playerName	喅
[Assembly-CSharp].NetObf.StrEncrypt::禽矍턳	啄
[Assembly-CSharp].NetObf.ResourcesTools	.喋
[Assembly-CSharp].NetObf.StrEncrypt::쿪씓儶	哘
[Assembly-CSharp].NetObf.StrEncrypt::낽鑧	啅
[Assembly-CSharp].NetObf.PlayerPrefsProtected::GetStringHashAsHex System.String([mscorlib].System.String)	匫
[Assembly-CSharp].Assets.Scripts.GameScripts.UI.Calibrate/<HandleCalibration>c__Iterator0::$disposing	咐
[Assembly-CSharp].Assets.Scripts.AudioControl.CalibrationTypes.CalibrationStyleLowFirst/<Calibrate>c__Iterator0::$disposing	咐
[Assembly-CSharp-firstpass].NetObf.StrEncrypt::蓱罻턳	吁
[Assembly-CSharp-firstpass].NetObf.StrEncrypt::褐济턴	华
[Assembly-CSharp].NetObf.ResourcesTools::GetResourceStream System.IO.Stream([mscorlib].System.Reflection.Assembly,[mscorlib].System.String)	医
[Assembly-CSharp].NetObf.StrEncrypt::錐슂	唬
[Assembly-CSharp-firstpass].NetObf.StrEncrypt::瘅齶儶	厇
[Assembly-CSharp].NetObf.StrEncrypt::묋豖儶	哐
[Assembly-CSharp].NetObf.StrEncrypt::ꃩꕤ턳	哏
[Assembly-CSharp].NetObf.StrEncrypt::눍詟턴	啯
[Assembly-CSharp].NetObf.Test::TestStr System.Boolean()	匠
[Assembly-CSharp-firstpass].NetObf.StrEncrypt::忲秧	呣
[Assembly-CSharp-firstpass].UnityStandardAssets.Utility.ParticleSystemDestroyer/<Start>c__Iterator0::$disposing	咐
[Assembly-CSharp-firstpass].NetObf.StrEncrypt::艈逗儶	叫
[Assembly-CSharp].NetObf.StrEncrypt::蓦Ꜫ턴	唶
[Assembly-CSharp-firstpass].NetObf.StrEncrypt::囸쨗	叢
[Assembly-CSharp].NetObf.PlayerPrefsProtected::SetString System.Void([mscorlib].System.String,[mscorlib].System.String)	匪
[Assembly-CSharp].NetObf.DemoMode::VerifyDemoModeExpirationTimeOnGUI System.Void()	匴
[Assembly-CSharp].NetObf.StrEncrypt::詵詉턴	哾
[Assembly-CSharp-firstpass].NetObf.StrEncrypt::舶蛧턴	叚
[Assembly-CSharp].NetObf.StrEncrypt::郺囂	卷
[Assembly-CSharp].NetObf.StrEncrypt::褔派턴	卐
[Assembly-CSharp].NetObf.BaseMeshSerializer::ReadVertices UnityEngine.Vector3[]([mscorlib].System.IO.BinaryReader,[mscorlib].System.Int32)	咃
[Assembly-CSharp-firstpass].NetObf.DemoMode::IsExpiredLevel System.Int32()	匲
[Assembly-CSharp].NetObf.StrEncrypt::뫽렴	咫
[Assembly-CSharp-firstpass].NetObf.StrEncrypt::掉栄턳	呠
[Assembly-CSharp-firstpass].NetObf.StrEncrypt::納瘆턳	呎
[Assembly-CSharp].NetObf.StrEncrypt::漫ꀍ턳	唓
[Assembly-CSharp].NetObf.StrEncrypt::褥浒턴	卪
[Assembly-CSharp-firstpass].NetObf.StrEncrypt::솫鵛턴	吗
[Assembly-CSharp].NetObf.StringLocalization::Get2LetterISOCodeFromSystemLanguage System.String()	匊
[Assembly-CSharp].NetObf.StrEncrypt::Rnd	卍
[Assembly-CSharp].NetObf.StrEncrypt::칠즷	唐
[Assembly-CSharp].NetObf.StrEncrypt::猕泽	唻
[Assembly-CSharp].NetObf.StrEncrypt::얂罅턳	唸
[Assembly-CSharp].NetObf.StrEncrypt::墒杰儶	啼
[Assembly-CSharp-firstpass].NetObf.StringLocalization::LoadLocalizationFileFromText System.Boolean([mscorlib].System.String)	匔
[Assembly-CSharp-firstpass].NetObf.ResourcesEncryption::LoadEncryptedResourceTexture UnityEngine.Texture2D([mscorlib].System.String,[mscorlib].System.String)	卆
[Assembly-CSharp].NetObf.DemoMode::VerifyDemoModeExpirationTime_GUI System.Void()	匶
[Assembly-CSharp-firstpass].UnityStandardAssets.Vehicles.Car.SkidTrail/<Start>c__Iterator0::$current	咏
[Assembly-CSharp-firstpass].UnityStandardAssets.Vehicles.Car.SkidTrail/<Start>c__Iterator0::$disposing	咐
[Assembly-CSharp].NetObf.StrEncrypt::채볗턳	咤
[Assembly-CSharp-firstpass].NetObf.StrEncrypt::绻廖턳	呮
[Assembly-CSharp].NetObf.StrEncrypt::뀏冾턴	唆
[Assembly-CSharp].NetObf.StrEncrypt::鴧稀	問
[Assembly-CSharp].NetObf.StringLocalization::UseOnlyAssemblyResources	匂
[Assembly-CSharp].NetObf.StrEncrypt::겪볁儶	啪
[Assembly-CSharp].NetObf.StrEncrypt	.喎
[Assembly-CSharp-firstpass].UnityStandardAssets.Utility.ObjectResetter/<ResetCoroutine>c__Iterator0::delay	咗
[Assembly-CSharp-firstpass].NetObf.StrEncrypt::荜큨儶	厦
[Assembly-CSharp].NetObf.StrEncrypt::纚超儶	啨
[Assembly-CSharp-firstpass].NetObf.StrEncrypt::茘謐	吨
[Assembly-CSharp].NetObf.StrEncrypt::霮鷴턳	唏
[Assembly-CSharp-firstpass].NetObf.StrEncrypt::怍琪儶	厼
[Assembly-CSharp-firstpass].NetObf.ImageConversionCustom::is_init	匾
[Assembly-CSharp-firstpass].NetObf.StrEncrypt::鑱朁	句
[Assembly-CSharp-firstpass].UnityStandardAssets.Utility.TimedObjectActivator/<ReloadLevel>c__Iterator2::$PC	咑
[Assembly-CSharp].NetObf.StrEncrypt::嘵樊턳	啴
[Assembly-CSharp-firstpass].NetObf.StrEncrypt::蜩ꊎ턳	历
[Assembly-CSharp-firstpass].NetObf.StrEncrypt::鷶뙟턴	吟
[Assembly-CSharp-firstpass].UnityStandardAssets.Utility.TimedObjectActivator/<ReloadLevel>c__Iterator2::$current	咏
[Assembly-CSharp-firstpass].NetObf.BaseMeshSerializer::ReadMeshHeader System.Void([mscorlib].System.IO.BinaryReader,[mscorlib].System.Int32&,[mscorlib].System.Int32&)	咁
[Assembly-CSharp-firstpass].NetObf.Crypto::DecryptString System.String([mscorlib].System.String,[mscorlib].System.String)	咍
[Assembly-CSharp-firstpass].UnityStandardAssets.Utility.ParticleSystemDestroyer/<Start>c__Iterator0::$locvar0	咓
[Assembly-CSharp-firstpass].UnityStandardAssets.Utility.ParticleSystemDestroyer/<Start>c__Iterator0::$locvar1	咔
[Assembly-CSharp-firstpass].UnityStandardAssets.Utility.ParticleSystemDestroyer/<Start>c__Iterator0::$locvar2	咕
[Assembly-CSharp-firstpass].NetObf.StrEncrypt::簲潟	厰
[Assembly-CSharp].NetObf.StringLocalization	.喆
[Assembly-CSharp-firstpass].NetObf.StrEncrypt::졸침	厲
[Assembly-CSharp-firstpass].UnityStandardAssets.Utility.ObjectResetter/<ResetCoroutine>c__Iterator0::$locvar0	咓
[Assembly-CSharp-firstpass].NetObf.StrEncrypt::벍ꮜ	呃
[Assembly-CSharp-firstpass].NetObf.StrEncrypt::麾믅턴	后
[Assembly-CSharp].Assets.Scripts.AudioControl.CalibrationTypes.CalibrationStyleLowFirst/<Calibrate>c__Iterator0::$PC	咑
[Assembly-CSharp-firstpass].NetObf.StrEncrypt::ꦻ聧儶	呝
[Assembly-CSharp-firstpass].NetObf.StringLocalization::PlayerPrefsGetString System.String([mscorlib].System.String)	匉
[Assembly-CSharp].NetObf.StrEncrypt::삓凾턳	唳
[Assembly-CSharp].NetObf.StrEncrypt::殠隤턳	啚
[Assembly-CSharp].NetObf.StrEncrypt::褏浦턴	卝
[Assembly-CSharp].NetObf.StrEncrypt::垞깊	喂
[Assembly-CSharp].NetObf.StrEncrypt::뗾嵕儶	唯
[Assembly-CSharp].NetObf.StringLocalization::ReadFromAssemblyDirectory System.String([mscorlib].System.String)	匛
[Assembly-CSharp-firstpass].NetObf.StrEncrypt::褢浒턴	卯
[Assembly-CSharp-firstpass].NetObf.StrEncrypt::热浟턳	厕
[Assembly-CSharp-firstpass].NetObf.StrEncrypt::꧴맍턳	叮
[Assembly-CSharp-firstpass].NetObf.ResourcesTools	.咝
[Assembly-CSharp].NetObf.StringLocalization::FindInChangeLang System.Action([System.Core].System.Action)	匞
[Assembly-CSharp-firstpass].NetObf.StrEncrypt::刑銆턴	吝
[Assembly-CSharp].NetObf.BaseMeshSerializer::SerializeMeshes System.Byte[]([mscorlib].System.Collections.Generic.IEnumerable`1)	呼
[Assembly-CSharp].NetObf.StrEncrypt::辶鴔턴	哇
[Assembly-CSharp].NetObf.PlayerPrefsProtected::GetString System.String([mscorlib].System.String,[mscorlib].System.String)	匧
[Assembly-CSharp-firstpass].NetObf.StrEncrypt::壣辆儶	及
[Assembly-CSharp].NetObf.ImageConversionCustom::is2017	匼
[Assembly-CSharp].NetObf.StrEncrypt::褐浒턴	卟
[Assembly-CSharp-firstpass].NetObf.StrEncrypt::꤮贲턴	吜
[Assembly-CSharp-firstpass].NetObf.StrEncrypt::麷閿儶	叁
[Assembly-CSharp-firstpass].NetObf.StrEncrypt::褐浒턴	卟
[Assembly-CSharp-firstpass].NetObf.StrEncrypt::ꖣ雐	叛
[Assembly-CSharp-firstpass].NetObf.StrEncrypt::list	卌
[Assembly-CSharp].NetObf.BaseMeshSerializer::ReadMeshHeader System.Void([mscorlib].System.IO.BinaryReader,[mscorlib].System.Int32&,[mscorlib].System.Int32&)	咁
[Assembly-CSharp-firstpass].NetObf.StrEncrypt::鬘뤸턳	叉
[Assembly-CSharp].NetObf.StrEncrypt::뇖狡턴	哪
[Assembly-CSharp-firstpass].NetObf.StrEncrypt::褒浤턴	南
[Assembly-CSharp].NetObf.BaseMeshSerializer::DeserializeMeshes System.Collections.Generic.IEnumerable`1<UnityEngine.Mesh>([mscorlib].System.Byte[])	命
[Assembly-CSharp].NetObf.StrEncrypt::녌腆	唝
[Assembly-CSharp].NetObf.StrEncrypt::甿봿턳	啀
[Assembly-CSharp-firstpass].NetObf.StrEncrypt::萊曱턴	厠
[Assembly-CSharp-firstpass].NetObf.StrEncrypt::褜浤턴	卢
[Assembly-CSharp-firstpass].NetObf.StrEncrypt::猊氽턳	厫
[Assembly-CSharp].NetObf.StrEncrypt::嚹뜨턴	哄
[Assembly-CSharp].NetObf.StringLocalization::Translate System.String([mscorlib].System.String)	匌
[Assembly-CSharp-firstpass].NetObf.StrEncrypt::鈱椚儶	吩
[Assembly-CSharp-firstpass].NetObf.StrEncrypt::Ꙙ篦턳	参
[Assembly-CSharp-firstpass].NetObf.StrEncrypt::掉経턳	变
[Assembly-CSharp-firstpass].NetObf.StrEncrypt::蝍눐	叒
[Assembly-CSharp].NetObf.StringLocalization::table_def	匃
[Assembly-CSharp].NetObf.StrEncrypt::DecryptStringUTF8 System.String([mscorlib].System.String)	呷
[Assembly-CSharp-firstpass].NetObf.StrEncrypt::鯍뒛턴	只
[Assembly-CSharp].NetObf.StrEncrypt::濭ꀍ턳	唕
[Assembly-CSharp].NetObf.StrEncrypt::袶泊턴	哋
[Assembly-CSharp].NetObf.StrEncrypt::닖燧턴	咹
[Assembly-CSharp].NetObf.StringLocalization::PlayerPrefsGetString System.String([mscorlib].System.String)	匉
[Assembly-CSharp].NetObf.StrEncrypt::鮝꺊	哽
[Assembly-CSharp-firstpass].NetObf.StrEncrypt::淔띙儶	厝
[Assembly-CSharp].NetObf.StringLocalization::RemoveFromChangeLang System.Void([System.Core].System.Action)	匓
[Assembly-CSharp].NetObf.StrEncrypt::瘅齶儶	厇
[Assembly-CSharp-firstpass].NetObf.StrEncrypt::褢浔턴	卮
[Assembly-CSharp].NetObf.StrEncrypt::褔浦턴	卑
[Assembly-CSharp-firstpass].NetObf.StrEncrypt::쮘瞸儶	呯
[Assembly-CSharp].NetObf.StrEncrypt::扺딀	唭
[Assembly-CSharp-firstpass].NetObf.StrEncrypt::꜄刈턴	厢
[Assembly-CSharp-firstpass].NetObf.PlayerPrefsProtected::GetFloat System.Single([mscorlib].System.String)	匥
[Assembly-CSharp-firstpass].NetObf.StrEncrypt::媸焹턴	厖
[Assembly-CSharp-firstpass].NetObf.StrEncrypt::ꌘ軝	厌
[Assembly-CSharp].NetObf.StrEncrypt::褝浠턴	卡
[Assembly-CSharp-firstpass].NetObf.StrEncrypt::桔묑儶	呬
[Assembly-CSharp].Assets.Scripts.GameScripts.UI.Calibrate/<HandleCalibration>c__Iterator0::$this	咎
[Assembly-CSharp].NetObf.StrEncrypt::撞ꡟ턴	叇
[Assembly-CSharp].NetObf.Crypto::DecryptBytes System.Byte[]([mscorlib].System.String,[mscorlib].System.String)	咋
[Assembly-CSharp].NetObf.StringLocalization::GetLanguageNames System.String[]()	匑
[Assembly-CSharp-firstpass].NetObf.StrEncrypt::垺賐턳	厘
[Assembly-CSharp-firstpass].NetObf.StrEncrypt::簔췞턳	史
[Assembly-CSharp].NetObf.StrEncrypt::赥骒儶	商
[Assembly-CSharp-firstpass].NetObf.DemoMode::IsExpired System.Boolean()	匱
[Assembly-CSharp].NetObf.StrEncrypt::ꙇꊥ턳	厅
[Assembly-CSharp].NetObf.StrEncrypt::괍姝턴	哙
[Assembly-CSharp-firstpass].NetObf.DemoMode::VerifyDemoModeExpirationTime System.Void()	匳
[Assembly-CSharp-firstpass].NetObf.PlayerPrefsProtected::HasKey System.Boolean([mscorlib].System.String)	匣
[Assembly-CSharp-firstpass].NetObf.StrEncrypt::ꬃ钿	吓
[Assembly-CSharp-firstpass].UnityStandardAssets.Utility.ObjectResetter/<ResetCoroutine>c__Iterator0::$current	咏
[Assembly-CSharp].NetObf.StrEncrypt::屧ꁴ儶	咴
[Assembly-CSharp].NetObf.Crypto::prefix	咇
[Assembly-CSharp-firstpass].NetObf.StrEncrypt::뷈讛턴	収
[Assembly-CSharp].NetObf.StrEncrypt::黈왍	啤
[Assembly-CSharp].NetObf.StrEncrypt::_DecryptStringFastInd System.String([mscorlib].System.String,[mscorlib].System.Int32)	呵
[Assembly-CSharp-firstpass].NetObf.StrEncrypt::蜝感	卹
[Assembly-CSharp-firstpass].NetObf.StrEncrypt::焴轘	厱
[Assembly-CSharp].Assets.Scripts.GameScripts.UI.Calibrate/<HandleCalibration>c__Iterator0::$current	咏
[Assembly-CSharp-firstpass].UnityStandardAssets.Utility.TimedObjectActivator/<Activate>c__Iterator0::$disposing	咐
[Assembly-CSharp].NetObf.StrEncrypt::좒쳗턳	可
[Assembly-CSharp].NetObf.Crypto::_DefaultEncryptPassword	咆
[Assembly-CSharp-firstpass].NetObf.StrEncrypt::챃煈턴	呋
[Assembly-CSharp].NetObf.StrEncrypt::褩洎턴	卾
[Assembly-CSharp].NetObf.StringLocalization::LocalizedResourcesLoad_type UnityEngine.Object([mscorlib].System.String,[mscorlib].System.Type)	化
[Assembly-CSharp-firstpass].NetObf.StrEncrypt::褏浌턴	卛
[Assembly-CSharp].NetObf.BaseMeshSerializer::ReadTriangleIndicies System.Int32[]([mscorlib].System.IO.BinaryReader,[mscorlib].System.Int32)	咅
[Assembly-CSharp].NetObf.StrEncrypt::呼暛儶	哑
[Assembly-CSharp].NetObf.StrEncrypt::褜浢턴	卤
[Assembly-CSharp].NetObf.StrEncrypt::鴪稀	啎
[Assembly-CSharp-firstpass].NetObf.StrEncrypt::鸅멗턳	厶
[Assembly-CSharp].NetObf.StrEncrypt::嘖걳턴	厎
[Assembly-CSharp-firstpass].NetObf.StringLocalization::table_base	匄
[Assembly-CSharp-firstpass].NetObf.Crypto::IsEncrypted System.Boolean([mscorlib].System.String)	咊
[Assembly-CSharp-firstpass].NetObf.StrEncrypt::愢擵턴	右
[Assembly-CSharp].NetObf.StrEncrypt::럪驫儶	啖
[Assembly-CSharp-firstpass].NetObf.DemoMode::expirationTime	匭
[Assembly-CSharp-firstpass].NetObf.StrEncrypt::裘泊턴	卽
[Assembly-CSharp].NetObf.Crypto::GetStringHash System.UInt32([mscorlib].System.String)	匝
[Assembly-CSharp-firstpass].NetObf.ImageConversionCustom::LoadImage_2017 System.Boolean([UnityEngine.CoreModule].UnityEngine.Texture2D,[mscorlib].System.Byte[])	匿
[Assembly-CSharp].NetObf.StringLocalization::_LoadDefaultResorceFile System.Boolean([mscorlib].System.String)	匙
[Assembly-CSharp-firstpass].NetObf.StrEncrypt::驇襈턳	厸
[Assembly-CSharp-firstpass].UnityStandardAssets.Utility.ObjectResetter/<ResetCoroutine>c__Iterator0::$this	咎
[Assembly-CSharp].NetObf.StrEncrypt::챑뤔턴	厔
[Assembly-CSharp-firstpass].NetObf.StrEncrypt::蔠騐	吽
[Assembly-CSharp].NetObf.StrEncrypt::늫뉸턴	哻
[Assembly-CSharp-firstpass].NetObf.ImageConversionCustom::LoadImageCustom System.Boolean([UnityEngine.CoreModule].UnityEngine.Texture2D,[mscorlib].System.Byte[])	十
[Assembly-CSharp].Assets.Scripts.AudioControl.CalibrationTypes.CalibrationStyleMiddleFirst/<Calibrate>c__Iterator0::$disposing	咐
[Assembly-CSharp-firstpass].NetObf.StrEncrypt::谫鑞	厑
[Assembly-CSharp-firstpass].NetObf.StrEncrypt::쯓糦儶	吻
[Assembly-CSharp].NetObf.StrEncrypt::霮鸠턳	唌
[Assembly-CSharp].NetObf.StrEncrypt::褡浦턴	即
[Assembly-CSharp-firstpass].NetObf.StrEncrypt::鋕옰턳	呱
[Assembly-CSharp].NetObf.StringLocalization::ReadFromAssemblyResources System.String([mscorlib].System.String)	匚
[Assembly-CSharp].NetObf.StrEncrypt::潔룸儶	啛
[Assembly-CSharp-firstpass].NetObf.StrEncrypt::恓袌儶	厺
[Assembly-CSharp-firstpass].NetObf.StrEncrypt::鶶뼮	呧
[Assembly-CSharp-firstpass].NetObf.StrEncrypt::绒勖턳	叜
[Assembly-CSharp-firstpass].NetObf.StrEncrypt::褣浠턴	协
[Assembly-CSharp].NetObf.ResourcesTools::GetResourcesList System.String[]([mscorlib].System.Reflection.Assembly)	区
[Assembly-CSharp-firstpass].NetObf.StrEncrypt::鍐똴턴	吣
[Assembly-CSharp].NetObf.StrEncrypt::晴鞾턴	員
[Assembly-CSharp].NetObf.StrEncrypt::縓徳儶	哆
[Assembly-CSharp-firstpass].NetObf.BaseMeshSerializer::WriteVertices System.Void([mscorlib].System.IO.BinaryWriter,[UnityEngine.CoreModule].UnityEngine.Vector3[],[UnityEngine.CoreModule].UnityEngine.Transform)	咂
[Assembly-CSharp-firstpass].NetObf.StrEncrypt::袶沌턴	卻
[Assembly-CSharp-firstpass].NetObf.StrEncrypt::廓爮	召
[Assembly-CSharp-firstpass].NetObf.StrEncrypt::鍖온턳	呩
[Assembly-CSharp].NetObf.StrEncrypt::踔즙턴	啂
[Assembly-CSharp].NetObf.StrEncrypt::떵꜓	哊
[Assembly-CSharp].NetObf.DemoMode	.喉
[Assembly-CSharp].NetObf.StrEncrypt::ꓧ쵀儶	啘
[Assembly-CSharp].NetObf.StrEncrypt::繭옟儶	咩
[Assembly-CSharp].NetObf.StrEncrypt::褜浤턴	卢
[Assembly-CSharp].NetObf.PlayerPrefsProtected::GetFloat System.Single([mscorlib].System.String)	匥
[Assembly-CSharp-firstpass].NetObf.StringLocalization::get_lang UnityEngine.SystemLanguage()	匇
[Assembly-CSharp].NetObf.StrEncrypt::럵쵵儶	啶
[Assembly-CSharp].NetObf.StrEncrypt::褓洼턴	協
[Assembly-CSharp-firstpass].NetObf.BaseMeshSerializer::WriteMeshHeader System.Void([mscorlib].System.IO.BinaryWriter,[mscorlib].System.Int32,[mscorlib].System.Int32)	咀
[Assembly-CSharp-firstpass].NetObf.StrEncrypt::괠쓲턴	吖
[Assembly-CSharp-firstpass].NetObf.DemoMode::st_text	匰
[Assembly-CSharp].NetObf.StrEncrypt::褜浜턴	占
[Assembly-CSharp-firstpass].NetObf.StrEncrypt::锗麵	吇
[Assembly-CSharp-firstpass].NetObf.StringLocalization::ReadFromAssemblyResources System.String([mscorlib].System.String)	匚
[Assembly-CSharp-firstpass].NetObf.StrEncrypt::즓閰턳	叞
[Assembly-CSharp-firstpass].NetObf.StrEncrypt::币徎턳	叓
[Assembly-CSharp].NetObf.StrEncrypt::鯍뒛턴	只
[Assembly-CSharp].NetObf.StringLocalization::table	包
[Assembly-CSharp].NetObf.StrEncrypt::辻鯋儶	哎
[Assembly-CSharp].NetObf.StrEncrypt::掜쎙턳	啈
[Assembly-CSharp-firstpass].NetObf.ResourcesEncryption::LoadEncryptedResourceBinary System.Byte[]([mscorlib].System.String,[mscorlib].System.String)	卅
[Assembly-CSharp].NetObf.StrEncrypt::頱漚儶	啱
[Assembly-CSharp].NetObf.StrEncrypt::져쭵턳	咵
[Assembly-CSharp].NetObf.StrEncrypt::ꂟ蜇儶	卶
[Assembly-CSharp].NetObf.ResourcesEncryption	.喍
[Assembly-CSharp].NetObf.StrEncrypt::鯼롰턳	咾
[Assembly-CSharp-firstpass].NetObf.Crypto::Decrypt System.Byte[]([mscorlib].System.Byte[],[mscorlib].System.String)	咉
[Assembly-CSharp-firstpass].NetObf.DemoMode::ExpirationAfterMinutes	匬
[Assembly-CSharp-firstpass].NetObf.StrEncrypt::줶賍	呢
[Assembly-CSharp-firstpass].NetObf.StringLocalization::GetStringHash System.UInt32([mscorlib].System.String)	匝
[Assembly-CSharp].NetObf.StrEncrypt::趍髰儶	啌
[Assembly-CSharp].NetObf.StrEncrypt::蘂蒢턴	哖
[Assembly-CSharp].NetObf.StrEncrypt::厵峩턳	啹
[Assembly-CSharp].NetObf.StrEncrypt::EncryptStringUTF8 System.String([mscorlib].System.String)	呸
[Assembly-CSharp].NetObf.StrEncrypt::괏鱢儶	哂
[Assembly-CSharp-firstpass].NetObf.StrEncrypt::턚筗	厚
[Assembly-CSharp].NetObf.StrEncrypt::蠡醏턳	吷
[Assembly-CSharp-firstpass].NetObf.StrEncrypt::覣瓌턴	吘
[Assembly-CSharp-firstpass].NetObf.StringLocalization::UseOnlyAssemblyResources	匂
[Assembly-CSharp-firstpass].NetObf.StrEncrypt::鳭꣩턳	吾
[Assembly-CSharp-firstpass].NetObf.StrEncrypt::慤唛儶	叩
[Assembly-CSharp].NetObf.StrEncrypt::ꫯ쥥	啰
[Assembly-CSharp]..<PrivateImplementationDetails>/.$ArrayType=24	喑
[Assembly-CSharp].NetObf.StrEncrypt::岻솔턴	厐
[Assembly-CSharp-firstpass].NetObf.BaseMeshSerializer::def_headerSize	呺
[Assembly-CSharp-firstpass].NetObf.StrEncrypt::褫浚턴	卖
[Assembly-CSharp].NetObf.StrEncrypt::攊凷턳	唇
[Assembly-CSharp].NetObf.StrEncrypt::舎邢턴	唫
[Assembly-CSharp-firstpass].NetObf.StrEncrypt::蝐貛儶	同
[Assembly-CSharp-firstpass].NetObf.StrEncrypt::饱ꊏ儶	告
[Assembly-CSharp-firstpass].NetObf.Crypto::GetStringHash System.UInt32([mscorlib].System.String)	匝
[Assembly-CSharp-firstpass].NetObf.StrEncrypt::鎿埠턴	厹
[Assembly-CSharp].NetObf.StrEncrypt::所捀儶	唧
[Assembly-CSharp-firstpass].NetObf.StrEncrypt::褢浚턴	卭
[Assembly-CSharp-firstpass].NetObf.StrEncrypt::黇鏺儶	呜
[Assembly-CSharp-firstpass].NetObf.StringLocalization::table_def	匃
[Assembly-CSharp-firstpass].NetObf.StrEncrypt::恒耰턳	厽
[Assembly-CSharp-firstpass].NetObf.StrEncrypt::킜컇	各
[Assembly-CSharp-firstpass].NetObf.ResourcesEncryption::LoadEncryptedResourceMesh System.Collections.Generic.IList`1<UnityEngine.Mesh>([mscorlib].System.String,[mscorlib].System.String)	午
[Assembly-CSharp].NetObf.StrEncrypt::쩙쪵턳	唟
[Assembly-CSharp-firstpass].NetObf.StrEncrypt::褜浢턴	卤
[Assembly-CSharp].NetObf.StrEncrypt::蚮璻	吼
[Assembly-CSharp-firstpass].NetObf.StrEncrypt::補泊턴	厁
[Assembly-CSharp].NetObf.StrEncrypt::愘잎	咸
[Assembly-CSharp].NetObf.StrEncrypt::DecryptStringBig System.String([mscorlib].System.String)	呹
[Assembly-CSharp-firstpass].NetObf.PlayerPrefsProtected::GetInt System.Int32([mscorlib].System.String,[mscorlib].System.Int32)	匦
[Assembly-CSharp-firstpass].NetObf.StrEncrypt::찮癵턴	叄
[Assembly-CSharp-firstpass].NetObf.StrEncrypt::郺囂	卷
[Assembly-CSharp-firstpass].NetObf.StrEncrypt::涰墯	呥
[Assembly-CSharp].NetObf.StrEncrypt::挘겋儶	咣
[Assembly-CSharp-firstpass].NetObf.StrEncrypt::뚿怪턳	呄
[Assembly-CSharp].NetObf.StrEncrypt::此워儶	哷
[Assembly-CSharp-firstpass].NetObf.PlayerPrefsProtected::SetFloat System.Void([mscorlib].System.String,[mscorlib].System.Single)	匨
[Assembly-CSharp].NetObf.StrEncrypt::넻腆	唞
[Assembly-CSharp].NetObf.StringLocalization::GetLocalizationKey System.Int32([mscorlib].System.String)	匍
[Assembly-CSharp].NetObf.ResourcesEncryption::LoadEncryptedResourceMesh System.Collections.Generic.IList`1<UnityEngine.Mesh>([mscorlib].System.String,[mscorlib].System.String)	午
[Assembly-CSharp].NetObf.StrEncrypt::脖縷	厈
[Assembly-CSharp].NetObf.StrEncrypt::꺕鄁턳	咧
[Assembly-CSharp].NetObf.ImageConversionCustom::is_init	匾
[Assembly-CSharp].Assets.Scripts.AudioControl.CalibrationTypes.CalibrationStyleMiddleFirst/<Calibrate>c__Iterator0::$current	咏
[Assembly-CSharp-firstpass].NetObf.StrEncrypt::踭眯턳	厬
[Assembly-CSharp].NetObf.StrEncrypt::쎬꓎턴	哗
[Assembly-CSharp-firstpass].NetObf.StrEncrypt::惹鼫	叟
[Assembly-CSharp-firstpass].NetObf.PlayerPrefsProtected	.咚
[Assembly-CSharp-firstpass].NetObf.PlayerPrefsProtected::Save System.Void()	匤
[Assembly-CSharp].NetObf.DemoMode::st_text	匰
[Assembly-CSharp-firstpass].NetObf.StringLocalization::LocalizedResourcesLoad_type UnityEngine.Object([mscorlib].System.String,[mscorlib].System.Type)	化
[Assembly-CSharp].Assets.Scripts.AudioControl.CalibrationTypes.CalibrationStyleMiddleFirst/<Calibrate>c__Iterator0::$this	咎
[Assembly-CSharp-firstpass].NetObf.StrEncrypt::褩洢턴	厀
[Assembly-CSharp].NetObf.StrEncrypt::嚧룗턴	叧
[Assembly-CSharp].NetObf.StringLocalization::AddToDefault System.Void([mscorlib].System.String)	匋
[Assembly-CSharp-firstpass].NetObf.StrEncrypt	.咠
[Assembly-CSharp-firstpass].NetObf.StrEncrypt::褜济턴	卣
[Assembly-CSharp-firstpass].NetObf.Crypto	.咢
[Assembly-CSharp-firstpass].NetObf.StrEncrypt::袸泊턴	厄
[Assembly-CSharp].NetObf.StringLocalization::changeLangActions	匆
[Assembly-CSharp].NetObf.StrEncrypt::왇룓턴	咳
[Assembly-CSharp].NetObf.StrEncrypt::緬덤턴	哯
[Assembly-CSharp-firstpass].NetObf.StrEncrypt::区腍턴	吳
[Assembly-CSharp].NetObf.StrEncrypt::瀎ꀍ턳	唔
[Assembly-CSharp-firstpass].NetObf.StrEncrypt::水栦턳	司
[Assembly-CSharp-firstpass].NetObf.StrEncrypt::좰遵턴	吉
[Assembly-CSharp-firstpass].NetObf.StrEncrypt::爟덜儶	启
[Assembly-CSharp].NetObf.Crypto	.喐
[Assembly-CSharp-firstpass].NetObf.StrEncrypt::턋랟턳	厉
[Assembly-CSharp-firstpass].NetObf.StrEncrypt::싒衽턴	呌
[Assembly-CSharp-firstpass].NetObf.StrEncrypt::馂糃儶	呁
[Assembly-CSharp].NetObf.StrEncrypt::캌삹턳	品
[Assembly-CSharp].NetObf.StrEncrypt::溯镟턳	唒
[Assembly-CSharp].NetObf.StrEncrypt::녭腆	唜
[Assembly-CSharp-firstpass].NetObf.StringLocalization::changeLangActions	匆
[Assembly-CSharp-firstpass].NetObf.StrEncrypt::릋淨	叅
[Assembly-CSharp].NetObf.StrEncrypt::낎腆	唛
[Assembly-CSharp-firstpass].NetObf.StrEncrypt::嘖걳턴	厎
[Assembly-CSharp-firstpass].NetObf.StrEncrypt::껺칖턳	叠
[Assembly-CSharp].NetObf.StrEncrypt::ꦉ쒐	啜
[Assembly-CSharp-firstpass].NetObf.StrEncrypt::潓鼀	吕
[Assembly-CSharp].NetObf.StrEncrypt::褐济턴	华
[Assembly-CSharp-firstpass].NetObf.StrEncrypt::帖蔔儶	厮
[Assembly-CSharp].NetObf.StrEncrypt::찎돷	唼
[Assembly-CSharp].NetObf.StrEncrypt::輹診	咺
[Assembly-CSharp-firstpass].NetObf.DM	.咜
[Assembly-CSharp].NetObf.Test::VerifyString	匟
