匁	lang
匂	UseOnlyAssemblyResources
匃	table_def
匄	table_base
包	table
匆	changeLangActions
匇	get_lang
匈	PlayerPrefsSetString
匉	PlayerPrefsGetString
匊	Get2LetterISOCodeFromSystemLanguage
匋	AddToDefault
匌	Translate
匍	GetLocalizationKey
匎	_Localization
匏	SelectLocalizationName
匐	GetSelectedLocalizationName
匑	GetLanguageNames
匒	AddToChangeLang
匓	RemoveFromChangeLang
匔	LoadLocalizationFileFromText
匕	LocalizedResourcesLoad
化	LocalizedResourcesLoad_type
匘	LoadDefaults
匙	_LoadDefaultResorceFile
匚	ReadFromAssemblyResources
匛	ReadFromAssemblyDirectory
匜	ReadFromUnityResorceAsset
匝	GetStringHash
匞	FindInChangeLang
匟	VerifyString
匠	TestStr
匡	DeleteAll
匢	DeleteKey
匣	HasKey
匤	Save
匥	GetFloat
匦	GetInt
匧	GetString
匨	SetFloat
匩	SetInt
匪	SetString
匫	GetStringHashAsHex
匬	ExpirationAfterMinutes
匭	expirationTime
匮	expirationTime2
匯	st_group
匰	st_text
匱	IsExpired
匲	IsExpiredLevel
匳	VerifyDemoModeExpirationTime
匴	VerifyDemoModeExpirationTimeOnGUI
匵	DrawExpirationMessage
匶	VerifyDemoModeExpirationTime_GUI
匷	expirationTime3
匸	expirationTime4
匹	resources
区	GetResourcesList
医	GetResourceStream
匼	is2017
匽	LoadImage_bytes
匾	is_init
匿	LoadImage_2017
區	EncodeToPNG_2017
十	LoadImageCustom
卂	disableLocalization
千	LoadEncryptedResourceDisbaleLocalization
卄	LoadEncryptedResourceText
卅	LoadEncryptedResourceBinary
卆	LoadEncryptedResourceTexture
升	LoadEncryptedResourceTextureEx
午	LoadEncryptedResourceMesh
卉	LoadEncryptedResourceAssetBundle
半	LoadEncryptedResourceAssetObject
卋	_STRING_ENCRYPT_KEY
卌	list
卍	Rnd
华	褐济턴
协	褣浠턴
卐	褔派턴
卑	褔浦턴
卒	褐浠턴
卓	褓浸턴
協	褓洼턴
单	褒浈턴
卖	褫浚턴
南	褒浤턴
単	褑浈턴
卙	褗浒턴
博	褐浢턴
卛	褏浌턴
卜	褏浘턴
卝	褏浦턴
卞	褑浀턴
卟	褐浒턴
占	褜浜턴
卡	褝浠턴
卢	褜浤턴
卣	褜济턴
卤	褜浢턴
卥	褛浈턴
卦	褚浌턴
卧	褙浞턴
卨	褙浢턴
卩	褗浌턴
卪	褥浒턴
卫	褥浢턴
卬	褣浌턴
卭	褢浚턴
卮	褢浔턴
卯	褢浒턴
印	褐浤턴
危	褢浞턴
卲	褡浚턴
即	褡浦턴
却	褠浔턴
卵	褟浘턴
卶	ꂟ蜇儶
卷	郺囂
卸	岹겺턴
卹	蜝感
卺	禾ꍏ턴
卻	袶沌턴
卼	褩洦턴
卽	裘泊턴
卾	褩洎턴
卿	裛泊턴
厀	褩洢턴
厁	補泊턴
厂	褩洲턴
厃	褉泊턴
厄	袸泊턴
厅	ꙇꊥ턳
历	蜩ꊎ턳
厇	瘅齶儶
厈	脖縷
厉	턋랟턳
厊	輐郐턳
压	ꡕ嬿턳
厌	ꌘ軝
厍	袷泊턴
厎	嘖걳턴
厏	櫔欣儶
厐	岻솔턴
厑	谫鑞
厒	뿛芚儶
厓	줞箥턳
厔	챑뤔턴
厕	热浟턳
厖	媸焹턴
厗	默鐿儶
厘	垺賐턳
厙	禒뜣턴
厚	턚筗
厛	ꗻꬲ儶
厜	枕딉턳
厝	淔띙儶
厞	ꏽ競
原	灳Ꝿ儶
厠	萊曱턴
厡	软ꆢ
厢	꜄刈턴
厣	좿좤턴
厤	舫누턴
厥	劸巆턴
厦	荜큨儶
厧	ꋶ灷턴
厨	獣禬턳
厩	꾲皑턴
厪	驒뿯턳
厫	猊氽턳
厬	踭眯턳
厭	녈롙
厮	帖蔔儶
厯	硱坚턴
厰	簲潟
厱	焴轘
厲	졸침
厳	嵸钅턳
厴	墌鼪儶
厵	쾅圓
厶	鸅멗턳
厷	櫋徬턳
厸	驇襈턳
厹	鎿埠턴
厺	恓袌儶
去	螚蒮儶
厼	怍琪儶
厽	恒耰턳
厾	쎚Ꙏ
县	ꗅ咴儶
叀	ꙑ篰턳
叁	麷閿儶
参	Ꙙ篦턳
參	鈈媖
叄	찮癵턴
叅	릋淨
叆	跄鋢儶
叇	撞ꡟ턴
又	럨禫턴
叉	鬘뤸턳
及	壣辆儶
友	炅ꏢ儶
双	鮿ꒃ儶
反	늸꘡턳
収	뷈讛턴
叏	螧埥
叐	鸘塯턳
发	馴嶌儶
叒	蝍눐
叓	币徎턳
叔	좻謦
叕	壬磟턴
取	嘿抑
受	鞥冿턴
变	掉経턳
叙	筰莔
叚	舶蛧턴
叛	ꖣ雐
叜	绒勖턳
叝	鴚拉
叞	즓閰턳
叟	惹鼫
叠	껺칖턳
叡	嚯食儶
叢	囸쨗
口	謚ꮮ턳
古	뾫쟈턳
句	鑱朁
另	绝謼
叧	嚧룗턴
叨	嚧앣턳
叩	慤唛儶
只	鯍뒛턴
叫	艈逗儶
召	廓爮
叭	螯辯儶
叮	꧴맍턳
可	좒쳗턳
台	崩듛턳
叱	鹰媥턴
史	簔췞턳
右	愢擵턴
叴	덤灗
叵	鮭ꐜ턴
叶	첦沯턴
号	笏즥儶
司	水栦턳
叹	뱩쌺
叺	吝昂턴
叻	극욷儶
叼	疿뉧턳
叽	跈썕턳
叾	捝꧎
叿	氍暿儶
吀	ꦺ瑆턳
吁	蓱罻턳
吂	钣夀턴
吃	梣웪儶
各	킜컇
吅	璾잹
吆	驭晄턳
吇	锗麵
合	ꄄ檍儶
吉	좰遵턴
吊	蛓寶턳
吋	斎냸儶
同	蝐貛儶
名	ꑮ纥턳
后	麾믅턴
吏	覫璻儶
吐	珡瑪턳
向	쟃댷
吒	湳꫚儶
吓	ꬃ钿
吔	빶鈇턳
吕	潓鼀
吖	괠쓲턴
吗	솫鵛턴
吘	覣瓌턴
吙	嵠諬턳
吚	首攸
君	ꔆ攻儶
吜	꤮贲턴
吝	刑銆턴
吞	滲叻儶
吟	鷶뙟턴
吠	徂ꢰ턴
吡	欸躩턴
吢	얅莉
吣	鍐똴턴
吤	蠡嶍儶
吥	꼜豐턳
否	罸ꡍ
吧	央譤儶
吨	茘謐
吩	鈱椚儶
吪	棤歰턳
含	故擪턳
听	퀋썷턴
吭	퀋ꅿ턴
吮	겪蟣儶
启	爟덜儶
吰	뿺孳
吱	箽떚턳
吲	ꪌ뜼턳
吳	区腍턴
吴	贕ꖌ
吵	캟눘
吶	栋刀턴
吷	蠡醏턳
吸	鞣ꭩ턴
吹	爵뇔
吺	趬郎儶
吻	쯓糦儶
吼	蚮璻
吽	蔠騐
吾	鳭꣩턳
吿	遮쳈턴
呀	맞긁턴
呁	馂糃儶
呂	蒬ꌮ儶
呃	벍ꮜ
呄	뚿怪턳
呅	艟빣턴
呆	菝帩
呇	祯漣턳
呈	睔蟁턳
呉	礌뷻턴
告	饱ꊏ儶
呋	챃煈턴
呌	싒衽턴
呍	褦泊턴
呎	納瘆턳
呏	娪ꃻ儶
呐	럍陱儶
呑	솫鴛儶
北`1	LocalizedResourcesLoad_Template
呓	Ꜯꏠ턴
呔	놔跋儶
呕	놔跉儶
呖	놔跇儶
呗	놔跅儶
员	媄鸁儶
呙	꽉龬
呚	饳ꀲ턳
呛	肹惘儶
呜	黇鏺儶
呝	ꦻ聧儶
呞	扶륑턳
呟	졉盪
呠	掉栄턳
呡	澥渖儶
呢	줶賍
呣	忲秧
呤	ꮒ喭儶
呥	涰墯
呦	즾깁
呧	鶶뼮
周	欱緩턴
呩	鍖온턳
呪	襾醇
呫	ꖧ칻턳
呬	桔묑儶
呭	殛幃儶
呮	绻廖턳
呯	쮘瞸儶
呰	欜闃儶
呱	鋕옰턳
呲	뮊凾턳
味	탍礵턴
呴	GetDefaultEncryptPassword
呵	_DecryptStringFastInd
呶	_DecryptStringFast
呷	DecryptStringUTF8
呸	EncryptStringUTF8
呹	DecryptStringBig
呺	def_headerSize
呻	Load
呼	SerializeMeshes
命	DeserializeMeshes
呾	WriteMesh
呿	ReadMesh
咀	WriteMeshHeader
咁	ReadMeshHeader
咂	WriteVertices
咃	ReadVertices
咄	WriteTriangleIndicies
咅	ReadTriangleIndicies
咆	_DefaultEncryptPassword
咇	prefix
咈	prefix2
咉	Decrypt
咊	IsEncrypted
咋	DecryptBytes
和	Decrypt_GetMeta
咍	DecryptString
咎	$this
咏	$current
咐	$disposing
咑	$PC
咒	entry
咓	$locvar0
咔	$locvar1
咕	$locvar2
咖	$locvar3
咗	delay
咘	StringLocalization
咙	Test
咚	PlayerPrefsProtected
咛	DemoMode
咜	DM
咝	ResourcesTools
咞	ImageConversionCustom
咟	ResourcesEncryption
咠	StrEncrypt
咡	BaseMeshSerializer
咢	Crypto
咣	挘겋儶
咤	채볗턳
咥	妩꾅
咦	鸆嚏턴
咧	꺕鄁턳
咨	蛯糣턳
咩	繭옟儶
咪	蕵熤
咫	뫽렴
咬	셧閃턳
咭	君謉턳
咮	긩듵
咯	됂睋턴
咰	痣塴
咱	嗅뉍턴
咲	绡ꕕ儶
咳	왇룓턴
咴	屧ꁴ儶
咵	져쭵턳
咶	ꍠ灮턳
咷	囱꼒儶
咸	愘잎
咹	닖燧턴
咺	輹診
咻	筤둊턳
咼	缓替턳
咽	録蔔턴
咾	鯼롰턳
咿	課猽턴
哀	鄌댐儶
品	캌삹턳
哂	괏鱢儶
哃	莣谸턴
哄	嚹뜨턴
哅	袵沀턴
哆	縓徳儶
哇	辶鴔턴
哈	廚릭儶
哉	繮墩
哊	떵꜓
哋	袶泊턴
哌	蒲趐儶
响	ꅫ椵턴
哎	辻鯋儶
哏	ꃩꕤ턳
哐	묋豖儶
哑	呼暛儶
哒	뵯腩儶
哓	짞싙턴
哔	鯨鱇
哕	谢趄턴
哖	蘂蒢턴
哗	쎬꓎턴
哘	쿪씓儶
哙	괍姝턴
哚	ꢒꦧ儶
哛	饾渮턳
哜	鴝첆턳
哝	ꁗ릮儶
哞	譟赛
哟	楾欼儶
哠	劕絉턴
員	晴鞾턴
哢	豵턣턳
哣	ꡃ鋛
哤	觖鞫
哥	怪줏턴
哦	鳏泿턳
哧	몓쌷儶
哨	ꅎ怋턳
哩	ꋱ罚턳
哪	뇖狡턴
哫	뿒랶턴
哬	좙皭턴
哭	ꁒ翓儶
哮	鴉뵏턳
哯	緬덤턴
哰	溝ꗨ턳
哱	钍洔턳
哲	逺聓儶
哳	焈廤턳
哴	踎飲
哵	까讆儶
哶	엖굡턳
哷	此워儶
哸	囼怕턴
哹	揌뙸儶
哺	뼙꣔
哻	늫뉸턴
哼	쮳婩턳
哽	鮝꺊
哾	詵詉턴
哿	履霦儶
唀	浠궥턴
唁	磅桖儶
唂	嚖롃
唃	懻狴턳
唄	뿌신儶
唅	囒蒑턳
唆	뀏冾턴
唇	攊凷턳
唈	닧狪턴
唉	큲娩
唊	霮鸬턳
唋	霮鸸턳
唌	霮鸠턳
唍	켯麉턴
唎	떻橷턳
唏	霮鷴턳
唐	칠즷
唑	責濿
唒	溯镟턳
唓	漫ꀍ턳
唔	瀎ꀍ턳
唕	濭ꀍ턳
唖	濐ꀍ턳
唗	蟋疐
唘	ꔈ疐
唙	ꁉ疐
唚	鱾疐
唛	낎腆
唜	녭腆
唝	녌腆
唞	넻腆
唟	쩙쪵턳
唠	떐ꥪ儶
唡	秦띢턴
唢	Ꙑ嵗턴
唣	Ꙑ嵑턴
唤	敽囖턴
唥	梋겑턴
唦	恼쫉
唧	所捀儶
唨	驧尠
唩	쭱首턳
唪	騸瑀턳
唫	舎邢턴
唬	錐슂
唭	扺딀
售	篖ꙺ턳
唯	뗾嵕儶
唰	厕养턴
唱	컅숚턳
唲	컅婦턴
唳	삓凾턳
唴	ꗎ纆턴
唵	吽懍턳
唶	蓦Ꜫ턴
唷	ꈅ姨
唸	얂罅턳
唹	딶碴
唺	빍袁턴
唻	猕泽
唼	찎돷
唽	騈骀턴
唾	禨꼘턴
唿	垂輤턴
啀	甿봿턳
啁	ꛟ牙
啂	踔즙턴
啃	鋵须儶
啄	禽矍턳
啅	낽鑧
商	赥骒儶
啇	簍饂턳
啈	掜쎙턳
啉	脡糦턳
啊	藖뵅턴
啋	萋嚟
啌	趍髰儶
啍	簸鶂턳
啎	鴪稀
問	鴧稀
啐	庙洷턳
啑	ꯌ쉰儶
啒	賿礜턴
啓	娕꟡턳
啔	괥昹
啕	结矄턴
啖	럪驫儶
啗	閨ꀄ턳
啘	ꓧ쵀儶
啙	Ꝃ젷턳
啚	殠隤턳
啛	潔룸儶
啜	ꦉ쒐
啝	唅뛘턳
啞	웷炁턳
啟	顩鄉턴
啠	譵녁턳
啡	쇈뵪턴
啢	讔쌒턳
啣	蟥簁턳
啤	黈왍
啥	ꮎ벬
啦	뿎朒儶
啧	寊쥺턳
啨	纚超儶
啩	탟뷫儶
啪	겪볁儶
啫	鹟衞턴
啬	溯噓
啭	쪭凮턳
啮	葟芑儶
啯	눍詟턴
啰	ꫯ쥥
啱	頱漚儶
啲	賖贿턴
啳	좝髙
啴	嘵樊턳
啵	꿃跿儶
啶	럵쵵儶
啷	蟖蜖儶
啸	鍙ꥺ턳
啹	厵峩턳
啺	鑽繱턳
啻	翳隣儶
啼	墒杰儶
啽	跠ꦋ儶
啾	瘀옫
啿	絙姤儶
喀	絙姢儶
喁	絙姆儶
喂	垞깊
喃	쐹礔턳
善	삽贩儶
喅	playerName
喆	StringLocalization
喇	Test
喈	PlayerPrefsProtected
喉	DemoMode
喊	DM
喋	ResourcesTools
喌	ImageConversionCustom
喍	ResourcesEncryption
喎	StrEncrypt
喏	BaseMeshSerializer
喐	Crypto
喑	$ArrayType=24
喒	$ArrayType=12
呒	겙瀵
